30 100
TTGCCAAACCGAAGTCACCTAAGCGGTAGG|TTGTATCCCAGTTGAGCCCCTCAGGCGAGA
CGGAAACTGGTTATACTTGGTTTGCCAAAC|AATCCTGGAGATCACGTGGGATTGTATCCC
ACCTCTGAAATGCAAGTCGGCCGGCCTATG|CTACAAACGCTCTAATCCTCTAGATCAAAT
GTCGGCCGGCCTATGCATACGAGTTCGTTC|TCCGGAAACTGGTTATACTTGGTTTGCCAA
AAATGCAAGTCGGCCGGCCTATGCATACGA|ATGCATACGAGCAAGTCGGCCGGCCTATGC
AATCCTCTAGATCAAATAAATGCAAGTCGG|CCTATGCATACGACGGCCCGCGGTGGTGTA
CGCCATGAATTTTCCTCGGAAGGTGAGCAT|AATCTAGAGCGATCTATATGTGATGAGTCA
CACCTAAGCGGTAGGAACCTTAAATGCAAG|GCCCCTCAGGCGAGATCGTCGGGATATGAG
CTTGGCCGTGTCCCGCAATTTAAAATGCAA|GCCATGAATTTTCCTCGGAAGGTGAGCATT
GGTGTATCTGTCGAATTCTTCGATACTTCC|AGGCCTATGCATACGAAAGGGGCTCTAGAA
TGCATACGATCAACGTGGCGAGTCGCTATG|GGCCTATGCATACGAGTTCGTTCGGGGAGT
TTTTCCGGGTGCCGTAAATCGGCACGAAAT|CGCGTACTAGAAGTTATACCGGCACCGATG
TCAACATGTTGCTACACCTAACCACAGGAG|GCCTATGCATACGAGAGTGTTTTAGGCAAA
ATAATACCGAAATGCAAGAAATGCAAGTCG|GAAACACAAAATGAAATGCAAGTCGGCCGG
CAAGTCGGCCGGCCTATGCATACGAGAGTG|ATGGCGCAAAGAAGAACAGAGGCCACGTGG
TGCTGGATTAACTCTGGTAACGCTTCTACA|TTCGTAAGAGATTAGTTGGTGAAATGCAAG
GATCGTCGGGATATGAGAAAGGTGGGCGAG|ATCCTCGAAATTGCAAATGCAAGTCGGCCG
AAGAGATTAGTTGGTGAAATGCAAGTCGGC|CGGTAGGAACCTTAAATGCAAGTCGGCCAA
GGTCTATTAGCCTCCTCATGGCGCAAAGAA|TCCTCCTGCGCCCTACGACGGCCTTTACTA
GCCGGCCTATGCATACGATCGGCCGGCCTA|CCTATGCATACGACAAGTCGGCCGGCCTAT
CCTATGCATACGAGCAAGTCGGCCGGCCTA|TCGAATTCTTCGATACTTCCGGAAACTGGT
CCGGGTGCCGTAAATCGGCACGAAATCCTC|TACTAGAAGTTATACCGGCACCGATGCTTT
GTTATACTTGGTTTGCCAAACCGAAGTCAC|GATCACGTGGGATTGTATCCCAGTTGAGCC
AAACCGAAGTCACCTAAGCGGTAGGAACCT|TCCCAGTTGAGCCCCTCAGGCGAGATCGTC
AGTCGGCCGGCCTATGCATACGACTTGGCC|CCTAACCACAGGAGTCTCGTAACGCCATGA
TCGGCCGGCCTATGCATACGACGGCCCGCG|GCCAAATGCAAGTCGGCCGGCCTATGCATA
TCTAGATCAAATAAATGCAAGTCGGCCGGC|GCATACGACGGCCCGCGGTGGTGTATCTGT
CGACAAGTCGGCCGGCCTATGCATACGAAA|CATACGATCAACGTGGCGAGTCGCTATGTG
CGGCCTATGCATACGAGGCCTATGCATACG|CATACCCGGCACTAAGACCTCACCGGACGA
CTCGAAATTGCAAATGCAAGTCGGCCGGCC|TTTCAACATGTTGCTACACCTAACCACAGG
GAGCCGCTGGTGTGCGAAACACAAAATGAA|GGCCGGCCTATGCATACGACTGTTCTGTCC
TGAGAAAGGTGGGCGAGGGCAATACATACC|CAAATGCAAGTCGGCCGGCCTATGCATACG
GTAAATCGGCACGAAATCCTCGAAATTGCA|TTATACCGGCACCGATGCTTTCAACATGTT
TGAGTGCTGGATTAACTCTGGTAACGCTTC|GCAATTCGTAAGAGATTAGTTGGTGAAATG
GCAAAGACACACCAATCTAGAGCGATCTAT|GCTACCCGTGCTGTCAGCCCTCCGAATATG
CTGGGCTTTGCGTGAGGTAAGAGCCGCTGG|CGACCTCTGAAATGCAAGTCGGCCGGCCTA
TGCCGTAAATCGGCACGAAATCCTCGAAAT|GAAGTTATACCGGCACCGATGCTTTCAACA
GCGTACTAGAAGTTATACCGGCACCGATGC|CTAAATACCCCTCTCCAAATGCAAGTCGGC
GATTAGTTGGTGAAATGCAAGTCGGCCGGC|AGGAACCTTAAATGCAAGTCGGCCAAATGC
GTGAGTGCTGGATTAACTCTGGTAACGCTT|TGCAATTCGTAAGAGATTAGTTGGTGAAAT
AAGTCGGCCGGCCTATGCATACGAGTCATT|TTTACGGGACATCTAGCTAACAAATAGGTA
GCGAGATCGTCGGGATATGAGAAAGGTGGG|CGAAATCCTCGAAATTGCAAATGCAAGTCG
AAGTCGGCCGGCCTATGCATACGAAAATGC|CGATCAACGTGGCGAGTCGCTATGTGAGTG
GTTGAGCCCCTCAGGCGAGATCGTCGGGAT|GCCGTAAATCGGCACGAAATCCTCGAAATT
ATTCGTTACGGGCCCGACTGTCATGCAGAT|AGTCGGCCGGCCTATGCATACGAGTCATTC
AAGTCGGCCGGCCTATGCATACGACGGCCC|TCGGCCAAATGCAAGTCGGCCGGCCTATGC
ATGCAAGTCGGCCGGCCTATGCATACGAGC|GCGGTGGTGTATCTGTCGAATTCTTCGATA
CGGCCTATGCATACGAGTCATTCGCGTACT|ACATCTAGCTAACAAATAGGTACCTAAATA
CGGACGAGATCGGATTCGTTACGGGCCCGA|AATTTAAAATGCAAGTCGGCCGGCCTATGC
GACTGTCATGCAGATTTTCCGGGTGCCGTA|GCATACGAGTCATTCGCGTACTAGAAGTTA
TACGAGTTCGTTCGGGGAGTGCAATTCGTA|CTTGGTTTGCCAAACCGAAGTCACCTAAGC
AGAGCGATCTATATGTGATGAGTCATGACT|CCTCCGAATATGTCAAAATCAAGGTTGTAA
ATAGGTACCTAAATACCCCTCTCCAAATGC|CTGCCACGTTACGGTCTATTAGCCTCCTCA
ATGCATACGAAAATGCAAGTCGGCCGGCCT|AGTCGCTATGTGAGTGCTGGATTAACTCTG
AAGTTATACCGGCACCGATGCTTTCAACAT|CCTCTCCAAATGCAAGTCGGCCGGCCTATG
GAAATCCTGGAGATCACGTGGGATTGTATC|TACGGGCCCGACTGTCATGCAGATTTTCCG
GTGCCGTAAATCGGCACGAAATCCTCGAAA|AGAAGTTATACCGGCACCGATGCTTTCAAC
CGGCCTATGCATACGATCAACGTGGCGAGT|GTCGGCCGGCCTATGCATACGAGTTCGTTC
GCATACGAGCAAGTCGGCCGGCCTATGCAT|TTCTTCGATACTTCCGGAAACTGGTTATAC
CCACGTTACGGTCTATTAGCCTCCTCATGG|AAGCGTTACTCCTCCTGCGCCCTACGACGG
AGTGCTGGATTAACTCTGGTAACGCTTCTA|AATTCGTAAGAGATTAGTTGGTGAAATGCA
CCTCTAGATCAAATAAATGCAAGTCGGCCG|ATGCATACGACGGCCCGCGGTGGTGTATCT
CCGTAAATCGGCACGAAATCCTCGAAATTG|AGTTATACCGGCACCGATGCTTTCAACATG
ATGAATTTTCCTCGGAAGGTGAGCATTTAC|TAGAGCGATCTATATGTGATGAGTCATGAC
CCCGCGGTGGTGTATCTGTCGAATTCTTCG|TGCATACGAGGCCTATGCATACGAAAGGGG
CGGCCTATGCATACGACTTGGCCGTGTCCC|ACAGGAGTCTCGTAACGCCATGAATTTTCC
TGTTCTGTCCATAAATGCAAGTCGGCCGGC|GTCGGCCGGCCTATGCATACGAGCAAGTCG
AAATGAAATGCAAGTCGGCCGGCCTATGCA|TCTGTCCATAAATGCAAGTCGGCCGGCCTA
GCCGGCCTATGCATACGACTTGGCCGTGTC|CCACAGGAGTCTCGTAACGCCATGAATTTT
TGCAAGTCGGCCGGCCTATGCATACGATCA|CATACGAGCAAGTCGGCCGGCCTATGCATA
TACTAGAAGTTATACCGGCACCGATGCTTT|AATACCCCTCTCCAAATGCAAGTCGGCCGG
CACGTGGGATTGTATCCCAGTTGAGCCCCT|TCATGCAGATTTTCCGGGTGCCGTAAATCG
ATACGAGGCCTATGCATACGAAAGGGGCTC|ACTAAGACCTCACCGGACGAGATCGGATTC
GCAAGTCGGCCGGCCTATGCATACGACAAG|AAATGCAAGTCGGCCGGCCTATGCATACGA
AGGAGTCTCGTAACGCCATGAATTTTCCTC|GCAAAGACACACCAATCTAGAGCGATCTAT
GAGAAAGGTGGGCGAGGGCAATACATACCC|AAATGCAAGTCGGCCGGCCTATGCATACGA
CCGGCACTAAGACCTCACCGGACGAGATCG|GACTTGGCCGTGTCCCGCAATTTAAAATGC
CGGGATATGAGAAAGGTGGGCGAGGGCAAT|GAAATTGCAAATGCAAGTCGGCCGGCCTAT
TGCGAAACACAAAATGAAATGCAAGTCGGC|CATACGACTGTTCTGTCCATAAATGCAAGT
CGCTGGTGTGCGAAACACAAAATGAAATGC|GGCCTATGCATACGACTGTTCTGTCCATAA
AGATCACGTGGGATTGTATCCCAGTTGAGC|ACTGTCATGCAGATTTTCCGGGTGCCGTAA
GGCCGGCCTATGCATACGACCTCTGAAATG|TTAACTCTGGTAACGCTTCTACAAACGCTC
GTCGGCCGGCCTATGCATACGATCGGCCGG|CCGGCCTATGCATACGACAAGTCGGCCGGC
GCCGGCCTATGCATACGACTGTTCTGTCCA|CTAGATCAAATAAATGCAAGTCGGCCGGCC
GATCTATATGTGATGAGTCATGACTGAGGC|GAATATGTCAAAATCAAGGTTGTAAACGAC
AGTACTGAAGGTCGGCCTGTTACGTGACCA|TTTGCGTGAGGTAAGAGCCGCTGGTGTGCG
GCCTATGCATACGAGTTCGTTCGGGGAGTG|CTGGTTATACTTGGTTTGCCAAACCGAAGT
CCGGCACCGATGCTTTCAACATGTTGCTAC|AATGCAAGTCGGCCGGCCTATGCATACGAG
GGCCGGCCTATGCATACGACTGTTCTGTCC|TCTAGATCAAATAAATGCAAGTCGGCCGGC
GATTTTCCGGGTGCCGTAAATCGGCACGAA|TTCGCGTACTAGAAGTTATACCGGCACCGA
CCGGCCTATGCATACGACTGTTCTGTCCAT|TAGATCAAATAAATGCAAGTCGGCCGGCCT
ATACGAAAATGCAAGTCGGCCGGCCTATGC|GCTATGTGAGTGCTGGATTAACTCTGGTAA
AATTCGTAAGAGATTAGTTGGTGAAATGCA|ACCTAAGCGGTAGGAACCTTAAATGCAAGT
ACCTAAATACCCCTCTCCAAATGCAAGTCG|CGTTACGGTCTATTAGCCTCCTCATGGCGC
CTAAATACCCCTCTCCAAATGCAAGTCGGC|TTACGGTCTATTAGCCTCCTCATGGCGCAA
GATCGGCCGGCCTATGCATACGAAAACACA|GTCGGCCGGCCTATGCATACGAAAATGCAA
ACGTGGCGAGTCGCTATGTGAGTGCTGGAT|CGAGTTCGTTCGGGGAGTGCAATTCGTAAG
ACAAAATGAAATGCAAGTCGGCCGGCCTAT|TGTTCTGTCCATAAATGCAAGTCGGCCGGC
GCATACGAGGCCTATGCATACGAAAGGGGC|GCACTAAGACCTCACCGGACGAGATCGGAT
GCCGGCCTATGCATACGAAAACACAATGCG|CCGGCCTATGCATACGAAAATGCAAGTCGG
GAGCGATCTATATGTGATGAGTCATGACTG|CTCCGAATATGTCAAAATCAAGGTTGTAAA
GGCCTATGCATACGACCTCTGAAATGCAAG|CTCTGGTAACGCTTCTACAAACGCTCTAAT
ACCGGACGAGATCGGATTCGTTACGGGCCC|GCAATTTAAAATGCAAGTCGGCCGGCCTAT
CTATGCATACGAGCAAGTCGGCCGGCCTAT|CGAATTCTTCGATACTTCCGGAAACTGGTT
GAGATCACGTGGGATTGTATCCCAGTTGAG|GACTGTCATGCAGATTTTCCGGGTGCCGTA
ATTGCAAATGCAAGTCGGCCGGCCTATGCA|CATGTTGCTACACCTAACCACAGGAGTCTC
TCGGCCAAATGCAAGTCGGCCGGCCTATGC|AAAGGTGGGCGAGGGCAATACATACCCGGC
GGCACGAAATCCTCGAAATTGCAAATGCAA|GGCACCGATGCTTTCAACATGTTGCTACAC
CAATCTAGAGCGATCTATATGTGATGAGTC|GTCAGCCCTCCGAATATGTCAAAATCAAGG
CAAGTCGGCCGGCCTATGCATACGAGTCAT|ATTTACGGGACATCTAGCTAACAAATAGGT
AAATGCAAGAAATGCAAGTCGGCCGGCCTA|AATGAAATGCAAGTCGGCCGGCCTATGCAT
CGACTTGGCCGTGTCCCGCAATTTAAAATG|AACGCCATGAATTTTCCTCGGAAGGTGAGC
CATGTTGCTACACCTAACCACAGGAGTCTC|ATGCATACGAGAGTGTTTTAGGCAAAGACA
CTGGTAACGCTTCTACAAACGCTCTAATCC|AGTTGGTGAAATGCAAGTCGGCCGGCCTAT
CCGGCCTATGCATACGAGGCCTATGCATAC|ACATACCCGGCACTAAGACCTCACCGGACG
TGAAATGCAAGTCGGCCGGCCTATGCATAC|GTCCATAAATGCAAGTCGGCCGGCCTATGC
TATGCATACGACAAGTCGGCCGGCCTATGC|GGCCTATGCATACGATCAACGTGGCGAGTC
CCTATGCATACGAGAGTGTTTTAGGCAAAG|AGAACAGAGGCCACGTGGCGTGGGGCTACC
GCATACGAAAGGGGCTCTAGAAATCCTGGA|CGGACGAGATCGGATTCGTTACGGGCCCGA
GGCCGGCCTATGCATACGACAAGTCGGCCG|AGTCGGCCGGCCTATGCATACGATCAACGT
ATGCATACGAGTCATTCGCGTACTAGAAGT|AGCTAACAAATAGGTACCTAAATACCCCTC
CGGCCTGTTACGTGACCATAATACCGAAAT|AAGAGCCGCTGGTGTGCGAAACACAAAATG
ATGCATACGATCGGCCGGCCTATGCATACG|TACGACAAGTCGGCCGGCCTATGCATACGA
TTAAAATGCAAGTCGGCCGGCCTATGCATA|AGGTGAGCATTTACGGGACATCTAGCTAAC
GCAATACATACCCGGCACTAAGACCTCACC|CCTATGCATACGACTTGGCCGTGTCCCGCA
CGAAATCCTCGAAATTGCAAATGCAAGTCG|CCGATGCTTTCAACATGTTGCTACACCTAA
TGAAGGTCGGCCTGTTACGTGACCATAATA|GTGAGGTAAGAGCCGCTGGTGTGCGAAACA
CCATAATACCGAAATGCAAGAAATGCAAGT|GCGAAACACAAAATGAAATGCAAGTCGGCC
AGATCGGATTCGTTACGGGCCCGACTGTCA|AAATGCAAGTCGGCCGGCCTATGCATACGA
AGGTCGGCCTGTTACGTGACCATAATACCG|AGGTAAGAGCCGCTGGTGTGCGAAACACAA
AAAGACACACCAATCTAGAGCGATCTATAT|TACCCGTGCTGTCAGCCCTCCGAATATGTC
GCCGGCCTATGCATACGACCTCTGAAATGC|TAACTCTGGTAACGCTTCTACAAACGCTCT
CGAGGCCTATGCATACGAAAGGGGCTCTAG|AAGACCTCACCGGACGAGATCGGATTCGTT
GGCCGTGTCCCGCAATTTAAAATGCAAGTC|ATGAATTTTCCTCGGAAGGTGAGCATTTAC
AATGCAAGTCGGCCGGCCTATGCATACGAG|CGCGGTGGTGTATCTGTCGAATTCTTCGAT
CGGCACTAAGACCTCACCGGACGAGATCGG|ACTTGGCCGTGTCCCGCAATTTAAAATGCA
ACAAACGCTCTAATCCTCTAGATCAAATAA|AAGTCGGCCGGCCTATGCATACGACGGCCC
GCAAGTCGGCCGGCCTATGCATACGATCAA|ATACGAGCAAGTCGGCCGGCCTATGCATAC
CCGGCCTATGCATACGAGTTCGTTCGGGGA|AAACTGGTTATACTTGGTTTGCCAAACCGA
CAGGAGTCTCGTAACGCCATGAATTTTCCT|GGCAAAGACACACCAATCTAGAGCGATCTA
GCTCTAATCCTCTAGATCAAATAAATGCAA|GCCGGCCTATGCATACGACGGCCCGCGGTG
GCCTGTTACGTGACCATAATACCGAAATGC|GAGCCGCTGGTGTGCGAAACACAAAATGAA
GGAACCTTAAATGCAAGTCGGCCAAATGCA|GATCGTCGGGATATGAGAAAGGTGGGCGAG
TACCCCTCTCCAAATGCAAGTCGGCCGGCC|GTCTATTAGCCTCCTCATGGCGCAAAGAAG
AAATGCAAGTCGGCCGGCCTATGCATACGA|CGCTCTAATCCTCTAGATCAAATAAATGCA
GGCCGGCCTATGCATACGACTTGGCCGTGT|ACCACAGGAGTCTCGTAACGCCATGAATTT
CCAGTTGAGCCCCTCAGGCGAGATCGTCGG|GGTGCCGTAAATCGGCACGAAATCCTCGAA
CTATGCATACGACGGCCCGCGGTGGTGTAT|AAGTCGGCCGGCCTATGCATACGAGGCCTA
AGGCAAAGACACACCAATCTAGAGCGATCT|GGGCTACCCGTGCTGTCAGCCCTCCGAATA
GGCCTATGCATACGACTTGGCCGTGTCCCG|CAGGAGTCTCGTAACGCCATGAATTTTCCT
CCATAAATGCAAGTCGGCCGGCCTATGCAT|GCCTATGCATACGAGCAAGTCGGCCGGCCT
AAATAAATGCAAGTCGGCCGGCCTATGCAT|CGGCCCGCGGTGGTGTATCTGTCGAATTCT
CTAAGACCTCACCGGACGAGATCGGATTCG|GCCGTGTCCCGCAATTTAAAATGCAAGTCG
TTCCGGAAACTGGTTATACTTGGTTTGCCA|AGAAATCCTGGAGATCACGTGGGATTGTAT
ACGACTGTTCTGTCCATAAATGCAAGTCGG|TGCAAGTCGGCCGGCCTATGCATACGAGCA
TATATCAACCCATAGTACTGAAGGTCGGCC|ATCTTAACTGGGCTTTGCGTGAGGTAAGAG
TCGGAAGGTGAGCATTTACGGGACATCTAG|ATATGTGATGAGTCATGACTGAGGCTTTAT
AGTCTCGTAACGCCATGAATTTTCCTCGGA|AAGACACACCAATCTAGAGCGATCTATATG
CAAAGACACACCAATCTAGAGCGATCTATA|CTACCCGTGCTGTCAGCCCTCCGAATATGT
AGAGTGTTTTAGGCAAAGACACACCAATCT|ACGTGGCGTGGGGCTACCCGTGCTGTCAGC
GCAAGTCGGCCGGCCTATGCATACGACCTC|TGCTGGATTAACTCTGGTAACGCTTCTACA
GAGTGTTTTAGGCAAAGACACACCAATCTA|CGTGGCGTGGGGCTACCCGTGCTGTCAGCC
ATGCAAGTCGGCCGGCCTATGCATACGACA|ATAAATGCAAGTCGGCCGGCCTATGCATAC
GGCCTATGCATACGAAAATGCAAGTCGGCC|TGGCGAGTCGCTATGTGAGTGCTGGATTAA
CCTAACCACAGGAGTCTCGTAACGCCATGA|GTGTTTTAGGCAAAGACACACCAATCTAGA
CATACGATCGGCCGGCCTATGCATACGAAA|GACAAGTCGGCCGGCCTATGCATACGAAAA
CCGTGTCCCGCAATTTAAAATGCAAGTCGG|GAATTTTCCTCGGAAGGTGAGCATTTACGG
GCAAATGCAAGTCGGCCGGCCTATGCATAC|GTTGCTACACCTAACCACAGGAGTCTCGTA
AATTCTTCGATACTTCCGGAAACTGGTTAT|CGAAAGGGGCTCTAGAAATCCTGGAGATCA
AAGTCACCTAAGCGGTAGGAACCTTAAATG|TTGAGCCCCTCAGGCGAGATCGTCGGGATA
GCCGGCCTATGCATACGACGGCCCGCGGTG|AAATGCAAGTCGGCCGGCCTATGCATACGA
ATACGACAAGTCGGCCGGCCTATGCATACG|ATGCATACGATCAACGTGGCGAGTCGCTAT
TTATCTTAACTGGGCTTTGCGTGAGGTAAG|CTATGCATACGACCTCTGAAATGCAAGTCG
GCGGCATTATCTTAACTGGGCTTTGCGTGA|GCCGGCCTATGCATACGACCTCTGAAATGC
TTGTATCCCAGTTGAGCCCCTCAGGCGAGA|TTTTCCGGGTGCCGTAAATCGGCACGAAAT
GCCTATGCATACGAAAATGCAAGTCGGCCG|GGCGAGTCGCTATGTGAGTGCTGGATTAAC
CTTCCGGAAACTGGTTATACTTGGTTTGCC|TAGAAATCCTGGAGATCACGTGGGATTGTA
TACCTAAATACCCCTCTCCAAATGCAAGTC|ACGTTACGGTCTATTAGCCTCCTCATGGCG
ACTTGGTTTGCCAAACCGAAGTCACCTAAG|CGTGGGATTGTATCCCAGTTGAGCCCCTCA
GACACACCAATCTAGAGCGATCTATATGTG|CCGTGCTGTCAGCCCTCCGAATATGTCAAA
TAACAAATAGGTACCTAAATACCCCTCTCC|AATTAACTGCCACGTTACGGTCTATTAGCC
GAGTCGCTATGTGAGTGCTGGATTAACTCT|GTTCGGGGAGTGCAATTCGTAAGAGATTAG
GCCGGCCTATGCATACGACAAGTCGGCCGG|GTCGGCCGGCCTATGCATACGATCAACGTG
CGTAAGAGATTAGTTGGTGAAATGCAAGTC|AAGCGGTAGGAACCTTAAATGCAAGTCGGC
TGCATACGACCTCTGAAATGCAAGTCGGCC|TAACGCTTCTACAAACGCTCTAATCCTCTA
GCTGGTGTGCGAAACACAAAATGAAATGCA|GCCTATGCATACGACTGTTCTGTCCATAAA
TGGTTTGCCAAACCGAAGTCACCTAAGCGG|GGGATTGTATCCCAGTTGAGCCCCTCAGGC
TCGGCCGGCCTATGCATACGAGCAAGTCGG|TGTATCTGTCGAATTCTTCGATACTTCCGG
CATACGAAAACACAATGCGCGGCATTATCT|ATACGAAAATGCAAGTCGGCCGGCCTATGC
CGCTATGTGAGTGCTGGATTAACTCTGGTA|GGGGAGTGCAATTCGTAAGAGATTAGTTGG
AGCATTTACGGGACATCTAGCTAACAAATA|AGTCATGACTGAGGCTTTATCAATTAACTG
ATGCATACGAGAGTGTTTTAGGCAAAGACA|ACAGAGGCCACGTGGCGTGGGGCTACCCGT
ACCTAAGCGGTAGGAACCTTAAATGCAAGT|CCCCTCAGGCGAGATCGTCGGGATATGAGA
CGGCCTATGCATACGAGAGTGTTTTAGGCA|AGAAGAACAGAGGCCACGTGGCGTGGGGCT
ATGGCGCAAAGAAGAACAGAGGCCACGTGG|ACGGCCTTTACTACACAGTATGATGTATGG
GTAAGAGATTAGTTGGTGAAATGCAAGTCG|AGCGGTAGGAACCTTAAATGCAAGTCGGCC
ATGCATACGAGCAAGTCGGCCGGCCTATGC|AATTCTTCGATACTTCCGGAAACTGGTTAT
AAGACACACCAATCTAGAGCGATCTATATG|ACCCGTGCTGTCAGCCCTCCGAATATGTCA
ATGCAAGTCGGCCGGCCTATGCATACGATC|GCATACGAGCAAGTCGGCCGGCCTATGCAT
GAAATGCAAGTCGGCCGGCCTATGCATACG|GCAAGTCGGCCGGCCTATGCATACGACAAG
TGCATACGAGAGTGTTTTAGGCAAAGACAC|CAGAGGCCACGTGGCGTGGGGCTACCCGTG
CGAAATGCAAGAAATGCAAGTCGGCCGGCC|AAAATGAAATGCAAGTCGGCCGGCCTATGC
TTCGCGTACTAGAAGTTATACCGGCACCGA|TACCTAAATACCCCTCTCCAAATGCAAGTC
AGCCGCTGGTGTGCGAAACACAAAATGAAA|GCCGGCCTATGCATACGACTGTTCTGTCCA
TCGTAAGAGATTAGTTGGTGAAATGCAAGT|TAAGCGGTAGGAACCTTAAATGCAAGTCGG
GATGCTTTCAACATGTTGCTACACCTAACC|TCGGCCGGCCTATGCATACGAGAGTGTTTT
ACAGGAGTCTCGTAACGCCATGAATTTTCC|AGGCAAAGACACACCAATCTAGAGCGATCT
CCCTCTCCAAATGCAAGTCGGCCGGCCTAT|TATTAGCCTCCTCATGGCGCAAAGAAGAAC
GCATACGAGAGTGTTTTAGGCAAAGACACA|AGAGGCCACGTGGCGTGGGGCTACCCGTGC
TTCGTTCGGGGAGTGCAATTCGTAAGAGAT|TTGCCAAACCGAAGTCACCTAAGCGGTAGG
CATAGTACTGAAGGTCGGCCTGTTACGTGA|GGCTTTGCGTGAGGTAAGAGCCGCTGGTGT
TCTACAAACGCTCTAATCCTCTAGATCAAA|TGCAAGTCGGCCGGCCTATGCATACGACGG
CTATTAGCCTCCTCATGGCGCAAAGAAGAA|TCCTGCGCCCTACGACGGCCTTTACTACAC
TGAGGCTTTATCAATTAACTGCCACGTTAC|AACGACATCTGTGTCATATATAAGCGTTAC
GCTAACAAATAGGTACCTAAATACCCCTCT|TCAATTAACTGCCACGTTACGGTCTATTAG
CTAGAAATCCTGGAGATCACGTGGGATTGT|CGTTACGGGCCCGACTGTCATGCAGATTTT
AACACAATGCGCGGCATTATCTTAACTGGG|ATGCAAGTCGGCCGGCCTATGCATACGACC
ATACGACGGCCCGCGGTGGTGTATCTGTCG|GCCGGCCTATGCATACGAGGCCTATGCATA
ATGTGAGTGCTGGATTAACTCTGGTAACGC|AGTGCAATTCGTAAGAGATTAGTTGGTGAA
GTCATGACTGAGGCTTTATCAATTAACTGC|AGGTTGTAAACGACATCTGTGTCATATATA
GGGGCTCTAGAAATCCTGGAGATCACGTGG|CGGATTCGTTACGGGCCCGACTGTCATGCA
GAGATCGGATTCGTTACGGGCCCGACTGTC|AAAATGCAAGTCGGCCGGCCTATGCATACG
CTATGCATACGAAAGGGGCTCTAGAAATCC|TCACCGGACGAGATCGGATTCGTTACGGGC
ATCCTCTAGATCAAATAAATGCAAGTCGGC|CTATGCATACGACGGCCCGCGGTGGTGTAT
TATGCATACGAGTCATTCGCGTACTAGAAG|TAGCTAACAAATAGGTACCTAAATACCCCT
CACTAAGACCTCACCGGACGAGATCGGATT|TGGCCGTGTCCCGCAATTTAAAATGCAAGT
CACAAAATGAAATGCAAGTCGGCCGGCCTA|CTGTTCTGTCCATAAATGCAAGTCGGCCGG
ATAGTACTGAAGGTCGGCCTGTTACGTGAC|GCTTTGCGTGAGGTAAGAGCCGCTGGTGTG
TCGGCCGGCCTATGCATACGATCAACGTGG|AGCAAGTCGGCCGGCCTATGCATACGAGTT
CATACGAGCAAGTCGGCCGGCCTATGCATA|TCTTCGATACTTCCGGAAACTGGTTATACT
AAATGCAAGTCGGCCGGCCTATGCATACGA|TCCTCATGGCGCAAAGAAGAACAGAGGCCA
TCTCGTAACGCCATGAATTTTCCTCGGAAG|GACACACCAATCTAGAGCGATCTATATGTG
TGCATACGACTTGGCCGTGTCCCGCAATTT|TCTCGTAACGCCATGAATTTTCCTCGGAAG
CCTATGCATACGAGTCATTCGCGTACTAGA|TCTAGCTAACAAATAGGTACCTAAATACCC
CGGGCCCGACTGTCATGCAGATTTTCCGGG|GGCCTATGCATACGAGTCATTCGCGTACTA
CGGCACGAAATCCTCGAAATTGCAAATGCA|CGGCACCGATGCTTTCAACATGTTGCTACA
CGGCCGGCCTATGCATACGACCTCTGAAAT|ATTAACTCTGGTAACGCTTCTACAAACGCT
AACAAATAGGTACCTAAATACCCCTCTCCA|ATTAACTGCCACGTTACGGTCTATTAGCCT
AATGCAAGTCGGCCGGCCTATGCATACGAT|TGCATACGAGCAAGTCGGCCGGCCTATGCA
CATCTAGCTAACAAATAGGTACCTAAATAC|GCTTTATCAATTAACTGCCACGTTACGGTC
CCTATGCATACGACTGTTCTGTCCATAAAT|TCAAATAAATGCAAGTCGGCCGGCCTATGC
AAAGGGGCTCTAGAAATCCTGGAGATCACG|GATCGGATTCGTTACGGGCCCGACTGTCAT
ATCTATATGTGATGAGTCATGACTGAGGCT|AATATGTCAAAATCAAGGTTGTAAACGACA
GACGGCCCGCGGTGGTGTATCTGTCGAATT|GCCTATGCATACGAGGCCTATGCATACGAA
CAGTTGAGCCCCTCAGGCGAGATCGTCGGG|GTGCCGTAAATCGGCACGAAATCCTCGAAA
ATGCATACGACTTGGCCGTGTCCCGCAATT|GTCTCGTAACGCCATGAATTTTCCTCGGAA
AGACCTCACCGGACGAGATCGGATTCGTTA|GTGTCCCGCAATTTAAAATGCAAGTCGGCC
CTAACCACAGGAGTCTCGTAACGCCATGAA|TGTTTTAGGCAAAGACACACCAATCTAGAG
TACGACTTGGCCGTGTCCCGCAATTTAAAA|GTAACGCCATGAATTTTCCTCGGAAGGTGA
TGCAAGTCGGCCGGCCTATGCATACGAGTC|GCATTTACGGGACATCTAGCTAACAAATAG
GGGAGTGCAATTCGTAAGAGATTAGTTGGT|CCGAAGTCACCTAAGCGGTAGGAACCTTAA
ACAAATAGGTACCTAAATACCCCTCTCCAA|TTAACTGCCACGTTACGGTCTATTAGCCTC
TCGCTATGTGAGTGCTGGATTAACTCTGGT|CGGGGAGTGCAATTCGTAAGAGATTAGTTG
AAGAAATGCAAGTCGGCCGGCCTATGCATA|ATGCAAGTCGGCCGGCCTATGCATACGACA
CGATACTTCCGGAAACTGGTTATACTTGGT|GGCTCTAGAAATCCTGGAGATCACGTGGGA
AATGCAAGTCGGCCGGCCTATGCATACGAC|GAGTGCTGGATTAACTCTGGTAACGCTTCT
CGAAGTCACCTAAGCGGTAGGAACCTTAAA|AGTTGAGCCCCTCAGGCGAGATCGTCGGGA
GAACCTTAAATGCAAGTCGGCCAAATGCAA|ATCGTCGGGATATGAGAAAGGTGGGCGAGG
TCCTCGGAAGGTGAGCATTTACGGGACATC|TCTATATGTGATGAGTCATGACTGAGGCTT
GCGAGGGCAATACATACCCGGCACTAAGAC|GGCCGGCCTATGCATACGACTTGGCCGTGT
TACCGGCACCGATGCTTTCAACATGTTGCT|CAAATGCAAGTCGGCCGGCCTATGCATACG
AATGAAATGCAAGTCGGCCGGCCTATGCAT|CTGTCCATAAATGCAAGTCGGCCGGCCTAT
ACGCTCTAATCCTCTAGATCAAATAAATGC|CGGCCGGCCTATGCATACGACGGCCCGCGG
GCGGTGGTGTATCTGTCGAATTCTTCGATA|ATACGAGGCCTATGCATACGAAAGGGGCTC
TTCCTCGGAAGGTGAGCATTTACGGGACAT|ATCTATATGTGATGAGTCATGACTGAGGCT
GAGGGCAATACATACCCGGCACTAAGACCT|CCGGCCTATGCATACGACTTGGCCGTGTCC
GAGTCATGACTGAGGCTTTATCAATTAACT|CAAGGTTGTAAACGACATCTGTGTCATATA
TCTCCAAATGCAAGTCGGCCGGCCTATGCA|TAGCCTCCTCATGGCGCAAAGAAGAACAGA
CGGTCTATTAGCCTCCTCATGGCGCAAAGA|CTCCTCCTGCGCCCTACGACGGCCTTTACT
GCGATCTATATGTGATGAGTCATGACTGAG|CCGAATATGTCAAAATCAAGGTTGTAAACG
TCCCAGTTGAGCCCCTCAGGCGAGATCGTC|CGGGTGCCGTAAATCGGCACGAAATCCTCG
CTTTATCAATTAACTGCCACGTTACGGTCT|CATCTGTGTCATATATAAGCGTTACTCCTC
AAGTCGGCCGGCCTATGCATACGACTTGGC|ACCTAACCACAGGAGTCTCGTAACGCCATG
TACGAGCAAGTCGGCCGGCCTATGCATACG|TTCGATACTTCCGGAAACTGGTTATACTTG
CAATACATACCCGGCACTAAGACCTCACCG|CTATGCATACGACTTGGCCGTGTCCCGCAA
AGTCGGCCGGCCTATGCATACGATCAACGT|CGAGCAAGTCGGCCGGCCTATGCATACGAG
CTGTTACGTGACCATAATACCGAAATGCAA|GCCGCTGGTGTGCGAAACACAAAATGAAAT
ACTAAGACCTCACCGGACGAGATCGGATTC|GGCCGTGTCCCGCAATTTAAAATGCAAGTC
GGTGAAATGCAAGTCGGCCGGCCTATGCAT|TAAATGCAAGTCGGCCAAATGCAAGTCGGC
TGCATACGAGTTCGTTCGGGGAGTGCAATT|TATACTTGGTTTGCCAAACCGAAGTCACCT
GCTTTGCGTGAGGTAAGAGCCGCTGGTGTG|CTCTGAAATGCAAGTCGGCCGGCCTATGCA
GCAAGTCGGCCGGCCTATGCATACGACGGC|AGTCGGCCAAATGCAAGTCGGCCGGCCTAT
GAGTGCTGGATTAACTCTGGTAACGCTTCT|CAATTCGTAAGAGATTAGTTGGTGAAATGC
AGTGCAATTCGTAAGAGATTAGTTGGTGAA|AAGTCACCTAAGCGGTAGGAACCTTAAATG
GCCTATGCATACGAGGCCTATGCATACGAA|TACCCGGCACTAAGACCTCACCGGACGAGA
GGGATTGTATCCCAGTTGAGCCCCTCAGGC|CAGATTTTCCGGGTGCCGTAAATCGGCACG
AAAATGCAAGTCGGCCGGCCTATGCATACG|GTGAGTGCTGGATTAACTCTGGTAACGCTT
CTATGCATACGAAAATGCAAGTCGGCCGGC|CGAGTCGCTATGTGAGTGCTGGATTAACTC
GTCGGCCGGCCTATGCATACGAGCAAGTCG|GTGTATCTGTCGAATTCTTCGATACTTCCG
CTGAGGCTTTATCAATTAACTGCCACGTTA|AAACGACATCTGTGTCATATATAAGCGTTA
ACACCAATCTAGAGCGATCTATATGTGATG|TGCTGTCAGCCCTCCGAATATGTCAAAATC
CTATGCATACGAGTCATTCGCGTACTAGAA|CTAGCTAACAAATAGGTACCTAAATACCCC
CCTCCTCATGGCGCAAAGAAGAACAGAGGC|CCCTACGACGGCCTTTACTACACAGTATGA
CCTCGGAAGGTGAGCATTTACGGGACATCT|CTATATGTGATGAGTCATGACTGAGGCTTT
ATTAGTTGGTGAAATGCAAGTCGGCCGGCC|GGAACCTTAAATGCAAGTCGGCCAAATGCA
TATGTGAGTGCTGGATTAACTCTGGTAACG|GAGTGCAATTCGTAAGAGATTAGTTGGTGA
GGTAAGAGCCGCTGGTGTGCGAAACACAAA|AAGTCGGCCGGCCTATGCATACGACTGTTC
AACTGGGCTTTGCGTGAGGTAAGAGCCGCT|TACGACCTCTGAAATGCAAGTCGGCCGGCC
TATGCATACGAGGCCTATGCATACGAAAGG|CCGGCACTAAGACCTCACCGGACGAGATCG
TCGGCCGGCCTATGCATACGAAAATGCAAG|TCAACGTGGCGAGTCGCTATGTGAGTGCTG
AATTTAAAATGCAAGTCGGCCGGCCTATGC|GGAAGGTGAGCATTTACGGGACATCTAGCT
TATGCATACGACTGTTCTGTCCATAAATGC|AAATAAATGCAAGTCGGCCGGCCTATGCAT
TCTAGAGCGATCTATATGTGATGAGTCATG|AGCCCTCCGAATATGTCAAAATCAAGGTTG
ATGCAAGTCGGCCGGCCTATGCATACGACT|CTCTAATCCTCTAGATCAAATAAATGCAAG
GAAATCCTCGAAATTGCAAATGCAAGTCGG|CGATGCTTTCAACATGTTGCTACACCTAAC
TTACGGGACATCTAGCTAACAAATAGGTAC|TGACTGAGGCTTTATCAATTAACTGCCACG
ATGCAAGTCGGCCGGCCTATGCATACGACT|CTACACCTAACCACAGGAGTCTCGTAACGC
ATTCGTAAGAGATTAGTTGGTGAAATGCAA|CCTAAGCGGTAGGAACCTTAAATGCAAGTC
GTTCGTTCGGGGAGTGCAATTCGTAAGAGA|TTTGCCAAACCGAAGTCACCTAAGCGGTAG
CATTTACGGGACATCTAGCTAACAAATAGG|TCATGACTGAGGCTTTATCAATTAACTGCC
TAACTGCCACGTTACGGTCTATTAGCCTCC|ATATATAAGCGTTACTCCTCCTGCGCCCTA
AATGCGCGGCATTATCTTAACTGGGCTTTG|AGTCGGCCGGCCTATGCATACGACCTCTGA
ACGACCTCTGAAATGCAAGTCGGCCGGCCT|CTTCTACAAACGCTCTAATCCTCTAGATCA
CTATGCATACGAGAGTGTTTTAGGCAAAGA|GAACAGAGGCCACGTGGCGTGGGGCTACCC
CGGCCCGCGGTGGTGTATCTGTCGAATTCT|CTATGCATACGAGGCCTATGCATACGAAAG
AGGTAAGAGCCGCTGGTGTGCGAAACACAA|CAAGTCGGCCGGCCTATGCATACGACTGTT
CCATAGTACTGAAGGTCGGCCTGTTACGTG|GGGCTTTGCGTGAGGTAAGAGCCGCTGGTG
TCGGGATATGAGAAAGGTGGGCGAGGGCAA|CGAAATTGCAAATGCAAGTCGGCCGGCCTA
GTTTGCCAAACCGAAGTCACCTAAGCGGTA|GATTGTATCCCAGTTGAGCCCCTCAGGCGA
TTAAATGCAAGTCGGCCAAATGCAAGTCGG|CGGGATATGAGAAAGGTGGGCGAGGGCAAT
TTGGTGAAATGCAAGTCGGCCGGCCTATGC|CTTAAATGCAAGTCGGCCAAATGCAAGTCG
GCTTTCAACATGTTGCTACACCTAACCACA|GCCGGCCTATGCATACGAGAGTGTTTTAGG
AGATCGTCGGGATATGAGAAAGGTGGGCGA|AATCCTCGAAATTGCAAATGCAAGTCGGCC
CCTAAGCGGTAGGAACCTTAAATGCAAGTC|CCCTCAGGCGAGATCGTCGGGATATGAGAA
GTAACGCTTCTACAAACGCTCTAATCCTCT|TGGTGAAATGCAAGTCGGCCGGCCTATGCA
CAGGCGAGATCGTCGGGATATGAGAAAGGT|GCACGAAATCCTCGAAATTGCAAATGCAAG
GATTGTATCCCAGTTGAGCCCCTCAGGCGA|GATTTTCCGGGTGCCGTAAATCGGCACGAA
TCTAGCTAACAAATAGGTACCTAAATACCC|TTTATCAATTAACTGCCACGTTACGGTCTA
CTCACCGGACGAGATCGGATTCGTTACGGG|CCCGCAATTTAAAATGCAAGTCGGCCGGCC
GAAGTTATACCGGCACCGATGCTTTCAACA|CCCTCTCCAAATGCAAGTCGGCCGGCCTAT
CCTATGCATACGATCGGCCGGCCTATGCAT|GCATACGACAAGTCGGCCGGCCTATGCATA
TGCAGATTTTCCGGGTGCCGTAAATCGGCA|GTCATTCGCGTACTAGAAGTTATACCGGCA
ATACCCCTCTCCAAATGCAAGTCGGCCGGC|GGTCTATTAGCCTCCTCATGGCGCAAAGAA
CACCTAACCACAGGAGTCTCGTAACGCCAT|GAGTGTTTTAGGCAAAGACACACCAATCTA
AATGCAAGTCGGCCGGCCTATGCATACGAC|CATAAATGCAAGTCGGCCGGCCTATGCATA
ACCACAGGAGTCTCGTAACGCCATGAATTT|TTTAGGCAAAGACACACCAATCTAGAGCGA
AATTTTCCTCGGAAGGTGAGCATTTACGGG|AGCGATCTATATGTGATGAGTCATGACTGA
GTCTCGTAACGCCATGAATTTTCCTCGGAA|AGACACACCAATCTAGAGCGATCTATATGT
CGGAAGGTGAGCATTTACGGGACATCTAGC|TATGTGATGAGTCATGACTGAGGCTTTATC
ATGCAAGTCGGCCGGCCTATGCATACGAGA|CTCATGGCGCAAAGAAGAACAGAGGCCACG
GCGTGAGGTAAGAGCCGCTGGTGTGCGAAA|AAATGCAAGTCGGCCGGCCTATGCATACGA
CCTATGCATACGAGTTCGTTCGGGGAGTGC|TGGTTATACTTGGTTTGCCAAACCGAAGTC
AAATGCAAGTCGGCCGGCCTATGCATACGA|TGAGTGCTGGATTAACTCTGGTAACGCTTC
CCTATGCATACGAAAACACAATGCGCGGCA|CTATGCATACGAAAATGCAAGTCGGCCGGC
ATGCATACGAGTTCGTTCGGGGAGTGCAAT|TTATACTTGGTTTGCCAAACCGAAGTCACC
ATCGGCACGAAATCCTCGAAATTGCAAATG|ACCGGCACCGATGCTTTCAACATGTTGCTA
ATCTAGAGCGATCTATATGTGATGAGTCAT|CAGCCCTCCGAATATGTCAAAATCAAGGTT
TCCTGGAGATCACGTGGGATTGTATCCCAG|GGCCCGACTGTCATGCAGATTTTCCGGGTG
GATCAACGTGGCGAGTCGCTATGTGAGTGC|GCATACGAGTTCGTTCGGGGAGTGCAATTC
GGTGTGCGAAACACAAAATGAAATGCAAGT|TATGCATACGACTGTTCTGTCCATAAATGC
ACCGGCACCGATGCTTTCAACATGTTGCTA|AAATGCAAGTCGGCCGGCCTATGCATACGA
GCCCCTCAGGCGAGATCGTCGGGATATGAG|AAATCGGCACGAAATCCTCGAAATTGCAAA
AAATGCAAGTCGGCCGGCCTATGCATACGA|TGCAAGTCGGCCAAATGCAAGTCGGCCGGC
CTAGAGCGATCTATATGTGATGAGTCATGA|GCCCTCCGAATATGTCAAAATCAAGGTTGT
GAAAGGTGGGCGAGGGCAATACATACCCGG|ATGCAAGTCGGCCGGCCTATGCATACGACT
TTATCAATTAACTGCCACGTTACGGTCTAT|TCTGTGTCATATATAAGCGTTACTCCTCCT
TGCATACGACTGTTCTGTCCATAAATGCAA|ATAAATGCAAGTCGGCCGGCCTATGCATAC
TACGAGGCCTATGCATACGAAAGGGGCTCT|CTAAGACCTCACCGGACGAGATCGGATTCG
AATGCAAGTCGGCCGGCCTATGCATACGAG|CCTCATGGCGCAAAGAAGAACAGAGGCCAC
AAGGTCGGCCTGTTACGTGACCATAATACC|GAGGTAAGAGCCGCTGGTGTGCGAAACACA
TCACGTGGGATTGTATCCCAGTTGAGCCCC|GTCATGCAGATTTTCCGGGTGCCGTAAATC
AAATCGGCACGAAATCCTCGAAATTGCAAA|ATACCGGCACCGATGCTTTCAACATGTTGC
CGAGATCGTCGGGATATGAGAAAGGTGGGC|GAAATCCTCGAAATTGCAAATGCAAGTCGG
GATACTTCCGGAAACTGGTTATACTTGGTT|GCTCTAGAAATCCTGGAGATCACGTGGGAT
GCAATTCGTAAGAGATTAGTTGGTGAAATG|TCACCTAAGCGGTAGGAACCTTAAATGCAA
GGTGGGCGAGGGCAATACATACCCGGCACT|AAGTCGGCCGGCCTATGCATACGACTTGGC
TAACTCTGGTAACGCTTCTACAAACGCTCT|AGATTAGTTGGTGAAATGCAAGTCGGCCGG
ATGTGATGAGTCATGACTGAGGCTTTATCA|TCAAAATCAAGGTTGTAAACGACATCTGTG
AATGCAAGTCGGCCGGCCTATGCATACGAC|GCTACACCTAACCACAGGAGTCTCGTAACG
CTCGGAAGGTGAGCATTTACGGGACATCTA|TATATGTGATGAGTCATGACTGAGGCTTTA
CATTCGCGTACTAGAAGTTATACCGGCACC|GGTACCTAAATACCCCTCTCCAAATGCAAG
CAAGTCGGCCGGCCTATGCATACGAGCAAG|GTGGTGTATCTGTCGAATTCTTCGATACTT
GCAAGTCGGCCGGCCTATGCATACGAGCAA|GGTGGTGTATCTGTCGAATTCTTCGATACT
CCTATGCATACGAAAGGGGCTCTAGAAATC|CTCACCGGACGAGATCGGATTCGTTACGGG
GCCGGCCTATGCATACGAGTCATTCGCGTA|GGACATCTAGCTAACAAATAGGTACCTAAA
GCCTATGCATACGACGGCCCGCGGTGGTGT|GCAAGTCGGCCGGCCTATGCATACGAGGCC
GATCGGATTCGTTACGGGCCCGACTGTCAT|AATGCAAGTCGGCCGGCCTATGCATACGAG
TCTGTCGAATTCTTCGATACTTCCGGAAAC|ATGCATACGAAAGGGGCTCTAGAAATCCTG
CTATGCATACGATCAACGTGGCGAGTCGCT|GCCGGCCTATGCATACGAGTTCGTTCGGGG
CATACGACTGTTCTGTCCATAAATGCAAGT|AAATGCAAGTCGGCCGGCCTATGCATACGA
GGAAGGTGAGCATTTACGGGACATCTAGCT|ATGTGATGAGTCATGACTGAGGCTTTATCA
TGCATACGATCGGCCGGCCTATGCATACGA|ACGACAAGTCGGCCGGCCTATGCATACGAA
GTCGGGATATGAGAAAGGTGGGCGAGGGCA|TCGAAATTGCAAATGCAAGTCGGCCGGCCT
TCTTCGATACTTCCGGAAACTGGTTATACT|AAGGGGCTCTAGAAATCCTGGAGATCACGT
TACCGAAATGCAAGAAATGCAAGTCGGCCG|CACAAAATGAAATGCAAGTCGGCCGGCCTA
TTCTTCGATACTTCCGGAAACTGGTTATAC|AAAGGGGCTCTAGAAATCCTGGAGATCACG
CCAATCTAGAGCGATCTATATGTGATGAGT|TGTCAGCCCTCCGAATATGTCAAAATCAAG
ACTAGAAGTTATACCGGCACCGATGCTTTC|ATACCCCTCTCCAAATGCAAGTCGGCCGGC
AGAAATGCAAGTCGGCCGGCCTATGCATAC|TGCAAGTCGGCCGGCCTATGCATACGACAA
CATAATACCGAAATGCAAGAAATGCAAGTC|CGAAACACAAAATGAAATGCAAGTCGGCCG
GGGCTTTGCGTGAGGTAAGAGCCGCTGGTG|ACCTCTGAAATGCAAGTCGGCCGGCCTATG
GGGTGCCGTAAATCGGCACGAAATCCTCGA|CTAGAAGTTATACCGGCACCGATGCTTTCA
TTTACGGGACATCTAGCTAACAAATAGGTA|ATGACTGAGGCTTTATCAATTAACTGCCAC
CTCTAGATCAAATAAATGCAAGTCGGCCGG|TGCATACGACGGCCCGCGGTGGTGTATCTG
AAGTCGGCCGGCCTATGCATACGAGAGTGT|TGGCGCAAAGAAGAACAGAGGCCACGTGGC
TACCCGGCACTAAGACCTCACCGGACGAGA|TACGACTTGGCCGTGTCCCGCAATTTAAAA
ACGTTACGGTCTATTAGCCTCCTCATGGCG|GCGTTACTCCTCCTGCGCCCTACGACGGCC
ACCTAACCACAGGAGTCTCGTAACGCCATG|AGTGTTTTAGGCAAAGACACACCAATCTAG
TTTTCCTCGGAAGGTGAGCATTTACGGGAC|CGATCTATATGTGATGAGTCATGACTGAGG
CAAGTCGGCCGGCCTATGCATACGACTGTT|TAATCCTCTAGATCAAATAAATGCAAGTCG
AGTCGGCCGGCCTATGCATACGAGAGTGTT|GGCGCAAAGAAGAACAGAGGCCACGTGGCG
GGCAATACATACCCGGCACTAAGACCTCAC|GCCTATGCATACGACTTGGCCGTGTCCCGC
GACTGAGGCTTTATCAATTAACTGCCACGT|GTAAACGACATCTGTGTCATATATAAGCGT
AGGCCTATGCATACGAAAGGGGCTCTAGAA|GACCTCACCGGACGAGATCGGATTCGTTAC
CAATTCGTAAGAGATTAGTTGGTGAAATGC|CACCTAAGCGGTAGGAACCTTAAATGCAAG
GTTGGTGAAATGCAAGTCGGCCGGCCTATG|CCTTAAATGCAAGTCGGCCAAATGCAAGTC
TTAACTCTGGTAACGCTTCTACAAACGCTC|GAGATTAGTTGGTGAAATGCAAGTCGGCCG
TCTGGTAACGCTTCTACAAACGCTCTAATC|TAGTTGGTGAAATGCAAGTCGGCCGGCCTA
TGAGCCCCTCAGGCGAGATCGTCGGGATAT|CGTAAATCGGCACGAAATCCTCGAAATTGC
GCCTATGCATACGAGTCATTCGCGTACTAG|ATCTAGCTAACAAATAGGTACCTAAATACC
TCCCGCAATTTAAAATGCAAGTCGGCCGGC|TTCCTCGGAAGGTGAGCATTTACGGGACAT
AGTTCGTTCGGGGAGTGCAATTCGTAAGAG|GTTTGCCAAACCGAAGTCACCTAAGCGGTA
TAGATCAAATAAATGCAAGTCGGCCGGCCT|ATACGACGGCCCGCGGTGGTGTATCTGTCG
TGTCATGCAGATTTTCCGGGTGCCGTAAAT|TACGAGTCATTCGCGTACTAGAAGTTATAC
CTCCTCATGGCGCAAAGAAGAACAGAGGCC|CCTACGACGGCCTTTACTACACAGTATGAT
ATTTTCCGGGTGCCGTAAATCGGCACGAAA|TCGCGTACTAGAAGTTATACCGGCACCGAT
AGCAAGTCGGCCGGCCTATGCATACGAGTT|ATACTTCCGGAAACTGGTTATACTTGGTTT
GCATACGAGTTCGTTCGGGGAGTGCAATTC|ATACTTGGTTTGCCAAACCGAAGTCACCTA
GCATACGACGGCCCGCGGTGGTGTATCTGT|CGGCCGGCCTATGCATACGAGGCCTATGCA
GGTTATACTTGGTTTGCCAAACCGAAGTCA|AGATCACGTGGGATTGTATCCCAGTTGAGC
TATGAGAAAGGTGGGCGAGGGCAATACATA|TGCAAATGCAAGTCGGCCGGCCTATGCATA
CACAGGAGTCTCGTAACGCCATGAATTTTC|TAGGCAAAGACACACCAATCTAGAGCGATC
TGCAAGTCGGCCGGCCTATGCATACGAGAG|TCATGGCGCAAAGAAGAACAGAGGCCACGT
GGCCTATGCATACGACTGTTCTGTCCATAA|GATCAAATAAATGCAAGTCGGCCGGCCTAT
ATCGGCCGGCCTATGCATACGAAAACACAA|TCGGCCGGCCTATGCATACGAAAATGCAAG
CATGACTGAGGCTTTATCAATTAACTGCCA|GTTGTAAACGACATCTGTGTCATATATAAG
ATGCATACGACTGTTCTGTCCATAAATGCA|AATAAATGCAAGTCGGCCGGCCTATGCATA
CCGGCCTATGCATACGAAAACACAATGCGC|CGGCCTATGCATACGAAAATGCAAGTCGGC
GCAAGTCGGCCGGCCTATGCATACGACTGT|CTAATCCTCTAGATCAAATAAATGCAAGTC
GAGTCTCGTAACGCCATGAATTTTCCTCGG|AAAGACACACCAATCTAGAGCGATCTATAT
TACGAAAACACAATGCGCGGCATTATCTTA|ACGAAAATGCAAGTCGGCCGGCCTATGCAT
GGCCTGTTACGTGACCATAATACCGAAATG|AGAGCCGCTGGTGTGCGAAACACAAAATGA
CGGCCGGCCTATGCATACGAGAGTGTTTTA|GCAAAGAAGAACAGAGGCCACGTGGCGTGG
ACTGGGCTTTGCGTGAGGTAAGAGCCGCTG|ACGACCTCTGAAATGCAAGTCGGCCGGCCT
AAATGCAAGTCGGCCAAATGCAAGTCGGCC|GGATATGAGAAAGGTGGGCGAGGGCAATAC
CAAATGCAAGTCGGCCGGCCTATGCATACG|TGGGCGAGGGCAATACATACCCGGCACTAA
AATGCAAGTCGGCCGGCCTATGCATACGAT|AAGTCGGCCGGCCTATGCATACGACAAGTC
TCAAATAAATGCAAGTCGGCCGGCCTATGC|GACGGCCCGCGGTGGTGTATCTGTCGAATT
AGCTAACAAATAGGTACCTAAATACCCCTC|ATCAATTAACTGCCACGTTACGGTCTATTA
TAAATGCAAGTCGGCCAAATGCAAGTCGGC|GGGATATGAGAAAGGTGGGCGAGGGCAATA
GGCGAGGGCAATACATACCCGGCACTAAGA|CGGCCGGCCTATGCATACGACTTGGCCGTG
CATACGAGGCCTATGCATACGAAAGGGGCT|CACTAAGACCTCACCGGACGAGATCGGATT
GAAATGCAAGTCGGCCGGCCTATGCATACG|ATGCAAGTCGGCCAAATGCAAGTCGGCCGG
GAAGGTCGGCCTGTTACGTGACCATAATAC|TGAGGTAAGAGCCGCTGGTGTGCGAAACAC
CGGCCGGCCTATGCATACGAGCAAGTCGGC|GTATCTGTCGAATTCTTCGATACTTCCGGA
TTGGTTTGCCAAACCGAAGTCACCTAAGCG|TGGGATTGTATCCCAGTTGAGCCCCTCAGG
ACGAAAACACAATGCGCGGCATTATCTTAA|CGAAAATGCAAGTCGGCCGGCCTATGCATA
ATGCAAGTCGGCCGGCCTATGCATACGACC|AGTGCTGGATTAACTCTGGTAACGCTTCTA
CTATGCATACGACTGTTCTGTCCATAAATG|CAAATAAATGCAAGTCGGCCGGCCTATGCA
TAAATACCCCTCTCCAAATGCAAGTCGGCC|TACGGTCTATTAGCCTCCTCATGGCGCAAA
CACGTTACGGTCTATTAGCCTCCTCATGGC|AGCGTTACTCCTCCTGCGCCCTACGACGGC
CCGCAATTTAAAATGCAAGTCGGCCGGCCT|CCTCGGAAGGTGAGCATTTACGGGACATCT
GCAAGTCGGCCGGCCTATGCATACGAGTCA|CATTTACGGGACATCTAGCTAACAAATAGG
GCCTATGCATACGATCGGCCGGCCTATGCA|TGCATACGACAAGTCGGCCGGCCTATGCAT
TCACCTAAGCGGTAGGAACCTTAAATGCAA|AGCCCCTCAGGCGAGATCGTCGGGATATGA
CGGCATTATCTTAACTGGGCTTTGCGTGAG|CCGGCCTATGCATACGACCTCTGAAATGCA
AGTCGGCCGGCCTATGCATACGACCTCTGA|TGGATTAACTCTGGTAACGCTTCTACAAAC
CTTAAATGCAAGTCGGCCAAATGCAAGTCG|TCGGGATATGAGAAAGGTGGGCGAGGGCAA
ATACGACTTGGCCGTGTCCCGCAATTTAAA|CGTAACGCCATGAATTTTCCTCGGAAGGTG
CCCGGCACTAAGACCTCACCGGACGAGATC|CGACTTGGCCGTGTCCCGCAATTTAAAATG
CACACCAATCTAGAGCGATCTATATGTGAT|GTGCTGTCAGCCCTCCGAATATGTCAAAAT
GCCTATGCATACGAGCAAGTCGGCCGGCCT|GTCGAATTCTTCGATACTTCCGGAAACTGG
GGCCTATGCATACGAGGCCTATGCATACGA|ATACCCGGCACTAAGACCTCACCGGACGAG
GGATATGAGAAAGGTGGGCGAGGGCAATAC|AATTGCAAATGCAAGTCGGCCGGCCTATGC
GGACATCTAGCTAACAAATAGGTACCTAAA|GAGGCTTTATCAATTAACTGCCACGTTACG
TACTGAAGGTCGGCCTGTTACGTGACCATA|TGCGTGAGGTAAGAGCCGCTGGTGTGCGAA
ACGAAATCCTCGAAATTGCAAATGCAAGTC|ACCGATGCTTTCAACATGTTGCTACACCTA
ACGACTTGGCCGTGTCCCGCAATTTAAAAT|TAACGCCATGAATTTTCCTCGGAAGGTGAG
TACATACCCGGCACTAAGACCTCACCGGAC|TGCATACGACTTGGCCGTGTCCCGCAATTT
CAAGAAATGCAAGTCGGCCGGCCTATGCAT|AATGCAAGTCGGCCGGCCTATGCATACGAC
AGGCGAGATCGTCGGGATATGAGAAAGGTG|CACGAAATCCTCGAAATTGCAAATGCAAGT
ATTATCTTAACTGGGCTTTGCGTGAGGTAA|CCTATGCATACGACCTCTGAAATGCAAGTC
TGTCCCGCAATTTAAAATGCAAGTCGGCCG|TTTTCCTCGGAAGGTGAGCATTTACGGGAC
GAAACTGGTTATACTTGGTTTGCCAAACCG|TCCTGGAGATCACGTGGGATTGTATCCCAG
ATCCCAGTTGAGCCCCTCAGGCGAGATCGT|CCGGGTGCCGTAAATCGGCACGAAATCCTC
CTGGTTATACTTGGTTTGCCAAACCGAAGT|GGAGATCACGTGGGATTGTATCCCAGTTGA
GACATCTAGCTAACAAATAGGTACCTAAAT|AGGCTTTATCAATTAACTGCCACGTTACGG
CTATGCATACGACTTGGCCGTGTCCCGCAA|GAGTCTCGTAACGCCATGAATTTTCCTCGG
CCCCTCAGGCGAGATCGTCGGGATATGAGA|AATCGGCACGAAATCCTCGAAATTGCAAAT
ATACGAGTCATTCGCGTACTAGAAGTTATA|AACAAATAGGTACCTAAATACCCCTCTCCA
GCCACGTTACGGTCTATTAGCCTCCTCATG|TAAGCGTTACTCCTCCTGCGCCCTACGACG
GCCAAATGCAAGTCGGCCGGCCTATGCATA|GGTGGGCGAGGGCAATACATACCCGGCACT
TTTCAACATGTTGCTACACCTAACCACAGG|CGGCCTATGCATACGAGAGTGTTTTAGGCA
TTTAAAATGCAAGTCGGCCGGCCTATGCAT|AAGGTGAGCATTTACGGGACATCTAGCTAA
TCTGAAATGCAAGTCGGCCGGCCTATGCAT|CAAACGCTCTAATCCTCTAGATCAAATAAA
CGAGAGTGTTTTAGGCAAAGACACACCAAT|CCACGTGGCGTGGGGCTACCCGTGCTGTCA
CGGCCGGCCTATGCATACGAGTTCGTTCGG|CGGAAACTGGTTATACTTGGTTTGCCAAAC
CCGGCCTATGCATACGAGCAAGTCGGCCGG|TCTGTCGAATTCTTCGATACTTCCGGAAAC
ACTGTTCTGTCCATAAATGCAAGTCGGCCG|AAGTCGGCCGGCCTATGCATACGAGCAAGT
AACTCTGGTAACGCTTCTACAAACGCTCTA|GATTAGTTGGTGAAATGCAAGTCGGCCGGC
AGTCGGCCGGCCTATGCATACGACTGTTCT|ATCCTCTAGATCAAATAAATGCAAGTCGGC
TCATTCGCGTACTAGAAGTTATACCGGCAC|AGGTACCTAAATACCCCTCTCCAAATGCAA
TGTGCGAAACACAAAATGAAATGCAAGTCG|TGCATACGACTGTTCTGTCCATAAATGCAA
AACTGGTTATACTTGGTTTGCCAAACCGAA|CTGGAGATCACGTGGGATTGTATCCCAGTT
ATATGAGAAAGGTGGGCGAGGGCAATACAT|TTGCAAATGCAAGTCGGCCGGCCTATGCAT
CGGCCGGCCTATGCATACGAGTCATTCGCG|CGGGACATCTAGCTAACAAATAGGTACCTA
CGATCTATATGTGATGAGTCATGACTGAGG|CGAATATGTCAAAATCAAGGTTGTAAACGA
GAGGCCTATGCATACGAAAGGGGCTCTAGA|AGACCTCACCGGACGAGATCGGATTCGTTA
TCGGCCGGCCTATGCATACGAAAACACAAT|CGGCCGGCCTATGCATACGAAAATGCAAGT
TATACTTGGTTTGCCAAACCGAAGTCACCT|TCACGTGGGATTGTATCCCAGTTGAGCCCC
TGCATACGACAAGTCGGCCGGCCTATGCAT|CCTATGCATACGATCAACGTGGCGAGTCGC
CTGTCCATAAATGCAAGTCGGCCGGCCTAT|GCCGGCCTATGCATACGAGCAAGTCGGCCG
AAACACAATGCGCGGCATTATCTTAACTGG|AATGCAAGTCGGCCGGCCTATGCATACGAC
GAGATCGTCGGGATATGAGAAAGGTGGGCG|AAATCCTCGAAATTGCAAATGCAAGTCGGC
TAAATGCAAGTCGGCCGGCCTATGCATACG|TATGCATACGAGCAAGTCGGCCGGCCTATG
AGCGGTAGGAACCTTAAATGCAAGTCGGCC|CAGGCGAGATCGTCGGGATATGAGAAAGGT
CACCGGACGAGATCGGATTCGTTACGGGCC|CGCAATTTAAAATGCAAGTCGGCCGGCCTA
TATGCATACGAAAATGCAAGTCGGCCGGCC|GAGTCGCTATGTGAGTGCTGGATTAACTCT
TAGAGCGATCTATATGTGATGAGTCATGAC|CCCTCCGAATATGTCAAAATCAAGGTTGTA
TGTGATGAGTCATGACTGAGGCTTTATCAA|CAAAATCAAGGTTGTAAACGACATCTGTGT
GGCCTATGCATACGAAAGGGGCTCTAGAAA|ACCTCACCGGACGAGATCGGATTCGTTACG
CTAACAAATAGGTACCTAAATACCCCTCTC|CAATTAACTGCCACGTTACGGTCTATTAGC
TTGCGTGAGGTAAGAGCCGCTGGTGTGCGA|TGAAATGCAAGTCGGCCGGCCTATGCATAC
CGTACTAGAAGTTATACCGGCACCGATGCT|TAAATACCCCTCTCCAAATGCAAGTCGGCC
TATGCATACGATCGGCCGGCCTATGCATAC|ATACGACAAGTCGGCCGGCCTATGCATACG
TATGTGATGAGTCATGACTGAGGCTTTATC|GTCAAAATCAAGGTTGTAAACGACATCTGT
ATAAATGCAAGTCGGCCGGCCTATGCATAC|GCCCGCGGTGGTGTATCTGTCGAATTCTTC
ACGAAAATGCAAGTCGGCCGGCCTATGCAT|TATGTGAGTGCTGGATTAACTCTGGTAACG
TCGGCCGGCCTATGCATACGACTTGGCCGT|TAACCACAGGAGTCTCGTAACGCCATGAAT
TCTAATCCTCTAGATCAAATAAATGCAAGT|CGGCCTATGCATACGACGGCCCGCGGTGGT
TGAAATGCAAGTCGGCCGGCCTATGCATAC|AATGCAAGTCGGCCAAATGCAAGTCGGCCG
GCCCGACTGTCATGCAGATTTTCCGGGTGC|CTATGCATACGAGTCATTCGCGTACTAGAA
GGCACTAAGACCTCACCGGACGAGATCGGA|CTTGGCCGTGTCCCGCAATTTAAAATGCAA
AAGTCGGCCGGCCTATGCATACGATCAACG|ACGAGCAAGTCGGCCGGCCTATGCATACGA
GGAAACTGGTTATACTTGGTTTGCCAAACC|ATCCTGGAGATCACGTGGGATTGTATCCCA
CCATGAATTTTCCTCGGAAGGTGAGCATTT|TCTAGAGCGATCTATATGTGATGAGTCATG
GAAACACAAAATGAAATGCAAGTCGGCCGG|ACGACTGTTCTGTCCATAAATGCAAGTCGG
AAACTGGTTATACTTGGTTTGCCAAACCGA|CCTGGAGATCACGTGGGATTGTATCCCAGT
TTACGGTCTATTAGCCTCCTCATGGCGCAA|TTACTCCTCCTGCGCCCTACGACGGCCTTT
GGCCCGCGGTGGTGTATCTGTCGAATTCTT|TATGCATACGAGGCCTATGCATACGAAAGG
AGTCATGACTGAGGCTTTATCAATTAACTG|AAGGTTGTAAACGACATCTGTGTCATATAT
TATGCATACGAGCAAGTCGGCCGGCCTATG|GAATTCTTCGATACTTCCGGAAACTGGTTA
CCGGCCTATGCATACGAGTCATTCGCGTAC|GACATCTAGCTAACAAATAGGTACCTAAAT
TGCAAGTCGGCCGGCCTATGCATACGACGG|AAGTCGGCCAAATGCAAGTCGGCCGGCCTA
TAGGAACCTTAAATGCAAGTCGGCCAAATG|GAGATCGTCGGGATATGAGAAAGGTGGGCG
ACGGGCCCGACTGTCATGCAGATTTTCCGG|CGGCCTATGCATACGAGTCATTCGCGTACT
GCAAGTCGGCCGGCCTATGCATACGACTTG|ACACCTAACCACAGGAGTCTCGTAACGCCA
GTATCTGTCGAATTCTTCGATACTTCCGGA|CCTATGCATACGAAAGGGGCTCTAGAAATC
GGCTCTAGAAATCCTGGAGATCACGTGGGA|GATTCGTTACGGGCCCGACTGTCATGCAGA
CGGCCGGCCTATGCATACGAAAACACAATG|GGCCGGCCTATGCATACGAAAATGCAAGTC
CGGCCTATGCATACGATCGGCCGGCCTATG|TATGCATACGACAAGTCGGCCGGCCTATGC
TCGGCACGAAATCCTCGAAATTGCAAATGC|CCGGCACCGATGCTTTCAACATGTTGCTAC
CACCGATGCTTTCAACATGTTGCTACACCT|CAAGTCGGCCGGCCTATGCATACGAGAGTG
TGCAAATGCAAGTCGGCCGGCCTATGCATA|TGTTGCTACACCTAACCACAGGAGTCTCGT
GTCGGCCGGCCTATGCATACGATCAACGTG|GAGCAAGTCGGCCGGCCTATGCATACGAGT
AACCCATAGTACTGAAGGTCGGCCTGTTAC|ACTGGGCTTTGCGTGAGGTAAGAGCCGCTG
ATCTTAACTGGGCTTTGCGTGAGGTAAGAG|ATGCATACGACCTCTGAAATGCAAGTCGGC
AAGTCGGCCGGCCTATGCATACGACTGTTC|AATCCTCTAGATCAAATAAATGCAAGTCGG
GATATGAGAAAGGTGGGCGAGGGCAATACA|ATTGCAAATGCAAGTCGGCCGGCCTATGCA
ACGACGGCCCGCGGTGGTGTATCTGTCGAA|CGGCCTATGCATACGAGGCCTATGCATACG
TTTCCTCGGAAGGTGAGCATTTACGGGACA|GATCTATATGTGATGAGTCATGACTGAGGC
CGTTACGGGCCCGACTGTCATGCAGATTTT|CGGCCGGCCTATGCATACGAGTCATTCGCG
TGTTGCTACACCTAACCACAGGAGTCTCGT|GCATACGAGAGTGTTTTAGGCAAAGACACA
AAAGGTGGGCGAGGGCAATACATACCCGGC|TGCAAGTCGGCCGGCCTATGCATACGACTT
ACACACCAATCTAGAGCGATCTATATGTGA|CGTGCTGTCAGCCCTCCGAATATGTCAAAA
AGTCGGCCAAATGCAAGTCGGCCGGCCTAT|AGAAAGGTGGGCGAGGGCAATACATACCCG
GTACCTAAATACCCCTCTCCAAATGCAAGT|CACGTTACGGTCTATTAGCCTCCTCATGGC
GTCGGCCGGCCTATGCATACGACTGTTCTG|TCCTCTAGATCAAATAAATGCAAGTCGGCC
GAGCCCCTCAGGCGAGATCGTCGGGATATG|GTAAATCGGCACGAAATCCTCGAAATTGCA
ATACGACCTCTGAAATGCAAGTCGGCCGGC|CGCTTCTACAAACGCTCTAATCCTCTAGAT
GAATTTTCCTCGGAAGGTGAGCATTTACGG|GAGCGATCTATATGTGATGAGTCATGACTG
AGTCGGCCGGCCTATGCATACGATCGGCCG|GCCGGCCTATGCATACGACAAGTCGGCCGG
TGGTGTATCTGTCGAATTCTTCGATACTTC|GAGGCCTATGCATACGAAAGGGGCTCTAGA
GGCCTATGCATACGAGAGTGTTTTAGGCAA|GAAGAACAGAGGCCACGTGGCGTGGGGCTA
CCCGACTGTCATGCAGATTTTCCGGGTGCC|TATGCATACGAGTCATTCGCGTACTAGAAG
CAAGTCGGCCAAATGCAAGTCGGCCGGCCT|TGAGAAAGGTGGGCGAGGGCAATACATACC
TCGTTCGGGGAGTGCAATTCGTAAGAGATT|TGCCAAACCGAAGTCACCTAAGCGGTAGGA
GAGTCATTCGCGTACTAGAAGTTATACCGG|AATAGGTACCTAAATACCCCTCTCCAAATG
GAGCAAGTCGGCCGGCCTATGCATACGAGT|GATACTTCCGGAAACTGGTTATACTTGGTT
ATGTTGCTACACCTAACCACAGGAGTCTCG|TGCATACGAGAGTGTTTTAGGCAAAGACAC
GCGCGGCATTATCTTAACTGGGCTTTGCGT|CGGCCGGCCTATGCATACGACCTCTGAAAT
CTCGTAACGCCATGAATTTTCCTCGGAAGG|ACACACCAATCTAGAGCGATCTATATGTGA
CATTATCTTAACTGGGCTTTGCGTGAGGTA|GCCTATGCATACGACCTCTGAAATGCAAGT
CTAGAAGTTATACCGGCACCGATGCTTTCA|TACCCCTCTCCAAATGCAAGTCGGCCGGCC
GTTTTAGGCAAAGACACACCAATCTAGAGC|GCGTGGGGCTACCCGTGCTGTCAGCCCTCC
GGCCGGCCTATGCATACGAGGCCTATGCAT|ATACATACCCGGCACTAAGACCTCACCGGA
GCAAGTCGGCCGGCCTATGCATACGAGTTC|TACTTCCGGAAACTGGTTATACTTGGTTTG
CTAATCCTCTAGATCAAATAAATGCAAGTC|GGCCTATGCATACGACGGCCCGCGGTGGTG
TCCAAATGCAAGTCGGCCGGCCTATGCATA|GCCTCCTCATGGCGCAAAGAAGAACAGAGG
GTGCTGGATTAACTCTGGTAACGCTTCTAC|ATTCGTAAGAGATTAGTTGGTGAAATGCAA
TGGTGTGCGAAACACAAAATGAAATGCAAG|CTATGCATACGACTGTTCTGTCCATAAATG
GCCGGCCTATGCATACGAAAATGCAAGTCG|ACGTGGCGAGTCGCTATGTGAGTGCTGGAT
CACCAATCTAGAGCGATCTATATGTGATGA|GCTGTCAGCCCTCCGAATATGTCAAAATCA
AGTTATACCGGCACCGATGCTTTCAACATG|CTCTCCAAATGCAAGTCGGCCGGCCTATGC
GCCGCTGGTGTGCGAAACACAAAATGAAAT|CCGGCCTATGCATACGACTGTTCTGTCCAT
TGCATACGAGCAAGTCGGCCGGCCTATGCA|ATTCTTCGATACTTCCGGAAACTGGTTATA
TGCAAGTCGGCCGGCCTATGCATACGACCT|GTGCTGGATTAACTCTGGTAACGCTTCTAC
GATCAAATAAATGCAAGTCGGCCGGCCTAT|ACGACGGCCCGCGGTGGTGTATCTGTCGAA
GCACTAAGACCTCACCGGACGAGATCGGAT|TTGGCCGTGTCCCGCAATTTAAAATGCAAG
CTATGCATACGAGGCCTATGCATACGAAAG|CCCGGCACTAAGACCTCACCGGACGAGATC
CGGTGGTGTATCTGTCGAATTCTTCGATAC|TACGAGGCCTATGCATACGAAAGGGGCTCT
ATACGAAAGGGGCTCTAGAAATCCTGGAGA|GACGAGATCGGATTCGTTACGGGCCCGACT
GGCCTATGCATACGACGGCCCGCGGTGGTG|TGCAAGTCGGCCGGCCTATGCATACGAGGC
GTGCGAAACACAAAATGAAATGCAAGTCGG|GCATACGACTGTTCTGTCCATAAATGCAAG
TCTGTCCATAAATGCAAGTCGGCCGGCCTA|GGCCGGCCTATGCATACGAGCAAGTCGGCC
GTCGAATTCTTCGATACTTCCGGAAACTGG|CATACGAAAGGGGCTCTAGAAATCCTGGAG
TGGAGATCACGTGGGATTGTATCCCAGTTG|CCGACTGTCATGCAGATTTTCCGGGTGCCG
GATTAACTCTGGTAACGCTTCTACAAACGC|AAGAGATTAGTTGGTGAAATGCAAGTCGGC
CCTAAATACCCCTCTCCAAATGCAAGTCGG|GTTACGGTCTATTAGCCTCCTCATGGCGCA
GCCGGCCTATGCATACGATCAACGTGGCGA|AAGTCGGCCGGCCTATGCATACGAGTTCGT
CAATGCGCGGCATTATCTTAACTGGGCTTT|AAGTCGGCCGGCCTATGCATACGACCTCTG
TGCCACGTTACGGTCTATTAGCCTCCTCAT|ATAAGCGTTACTCCTCCTGCGCCCTACGAC
TGACCATAATACCGAAATGCAAGAAATGCA|TGTGCGAAACACAAAATGAAATGCAAGTCG
TACGGGACATCTAGCTAACAAATAGGTACC|GACTGAGGCTTTATCAATTAACTGCCACGT
CGGGGAGTGCAATTCGTAAGAGATTAGTTG|AACCGAAGTCACCTAAGCGGTAGGAACCTT
AACCGAAGTCACCTAAGCGGTAGGAACCTT|CCCAGTTGAGCCCCTCAGGCGAGATCGTCG
GAGGCTTTATCAATTAACTGCCACGTTACG|ACGACATCTGTGTCATATATAAGCGTTACT
CGAGTCGCTATGTGAGTGCTGGATTAACTC|CGTTCGGGGAGTGCAATTCGTAAGAGATTA
AATTGCAAATGCAAGTCGGCCGGCCTATGC|ACATGTTGCTACACCTAACCACAGGAGTCT
CGCTCTAATCCTCTAGATCAAATAAATGCA|GGCCGGCCTATGCATACGACGGCCCGCGGT
TCATGCAGATTTTCCGGGTGCCGTAAATCG|CGAGTCATTCGCGTACTAGAAGTTATACCG
ATGCAAGTCGGCCGGCCTATGCATACGAGT|AGCATTTACGGGACATCTAGCTAACAAATA
CGTCGGGATATGAGAAAGGTGGGCGAGGGC|CTCGAAATTGCAAATGCAAGTCGGCCGGCC
TCGGCCTGTTACGTGACCATAATACCGAAA|TAAGAGCCGCTGGTGTGCGAAACACAAAAT
AGTCGGCCGGCCTATGCATACGAGCAAGTC|GGTGTATCTGTCGAATTCTTCGATACTTCC
ATTCGCGTACTAGAAGTTATACCGGCACCG|GTACCTAAATACCCCTCTCCAAATGCAAGT
TAGTTGGTGAAATGCAAGTCGGCCGGCCTA|AACCTTAAATGCAAGTCGGCCAAATGCAAG
ATACCGAAATGCAAGAAATGCAAGTCGGCC|ACACAAAATGAAATGCAAGTCGGCCGGCCT
CGGCCGGCCTATGCATACGACGGCCCGCGG|CCAAATGCAAGTCGGCCGGCCTATGCATAC
TGTGAGTGCTGGATTAACTCTGGTAACGCT|GTGCAATTCGTAAGAGATTAGTTGGTGAAA
AGTTGAGCCCCTCAGGCGAGATCGTCGGGA|TGCCGTAAATCGGCACGAAATCCTCGAAAT
CGCGTACTAGAAGTTATACCGGCACCGATG|CCTAAATACCCCTCTCCAAATGCAAGTCGG
ATCACGTGGGATTGTATCCCAGTTGAGCCC|TGTCATGCAGATTTTCCGGGTGCCGTAAAT
TACACCTAACCACAGGAGTCTCGTAACGCC|GAGAGTGTTTTAGGCAAAGACACACCAATC
TTTAGGCAAAGACACACCAATCTAGAGCGA|GTGGGGCTACCCGTGCTGTCAGCCCTCCGA
CTTCGATACTTCCGGAAACTGGTTATACTT|AGGGGCTCTAGAAATCCTGGAGATCACGTG
GTGTCCCGCAATTTAAAATGCAAGTCGGCC|ATTTTCCTCGGAAGGTGAGCATTTACGGGA
TCATGGCGCAAAGAAGAACAGAGGCCACGT|CGACGGCCTTTACTACACAGTATGATGTAT
TACGACCTCTGAAATGCAAGTCGGCCGGCC|GCTTCTACAAACGCTCTAATCCTCTAGATC
CCTGGAGATCACGTGGGATTGTATCCCAGT|GCCCGACTGTCATGCAGATTTTCCGGGTGC
GGCCTATGCATACGAAAACACAATGCGCGG|GCCTATGCATACGAAAATGCAAGTCGGCCG
CAACCCATAGTACTGAAGGTCGGCCTGTTA|AACTGGGCTTTGCGTGAGGTAAGAGCCGCT
TACAAACGCTCTAATCCTCTAGATCAAATA|CAAGTCGGCCGGCCTATGCATACGACGGCC
CGTTCGGGGAGTGCAATTCGTAAGAGATTA|GCCAAACCGAAGTCACCTAAGCGGTAGGAA
TACGGTCTATTAGCCTCCTCATGGCGCAAA|TACTCCTCCTGCGCCCTACGACGGCCTTTA
AATCGGCACGAAATCCTCGAAATTGCAAAT|TACCGGCACCGATGCTTTCAACATGTTGCT
TGCAATTCGTAAGAGATTAGTTGGTGAAAT|GTCACCTAAGCGGTAGGAACCTTAAATGCA
GCCGGCCTATGCATACGAGTTCGTTCGGGG|GAAACTGGTTATACTTGGTTTGCCAAACCG
CGAAAACACAATGCGCGGCATTATCTTAAC|GAAAATGCAAGTCGGCCGGCCTATGCATAC
CCTATGCATACGACTTGGCCGTGTCCCGCA|GGAGTCTCGTAACGCCATGAATTTTCCTCG
ACATGTTGCTACACCTAACCACAGGAGTCT|TATGCATACGAGAGTGTTTTAGGCAAAGAC
TAACTGGGCTTTGCGTGAGGTAAGAGCCGC|ATACGACCTCTGAAATGCAAGTCGGCCGGC
AATAAATGCAAGTCGGCCGGCCTATGCATA|GGCCCGCGGTGGTGTATCTGTCGAATTCTT
TCGGCCGGCCTATGCATACGACCTCTGAAA|GATTAACTCTGGTAACGCTTCTACAAACGC
AGAGATTAGTTGGTGAAATGCAAGTCGGCC|GGTAGGAACCTTAAATGCAAGTCGGCCAAA
ATACGATCAACGTGGCGAGTCGCTATGTGA|CTATGCATACGAGTTCGTTCGGGGAGTGCA
GTAGGAACCTTAAATGCAAGTCGGCCAAAT|CGAGATCGTCGGGATATGAGAAAGGTGGGC
TTATACTTGGTTTGCCAAACCGAAGTCACC|ATCACGTGGGATTGTATCCCAGTTGAGCCC
AAGTCGGCCAAATGCAAGTCGGCCGGCCTA|GAGAAAGGTGGGCGAGGGCAATACATACCC
ATCTGTCGAATTCTTCGATACTTCCGGAAA|TATGCATACGAAAGGGGCTCTAGAAATCCT
ATTGTATCCCAGTTGAGCCCCTCAGGCGAG|ATTTTCCGGGTGCCGTAAATCGGCACGAAA
CGCGGTGGTGTATCTGTCGAATTCTTCGAT|CATACGAGGCCTATGCATACGAAAGGGGCT
GGCCGGCCTATGCATACGAGCAAGTCGGCC|TATCTGTCGAATTCTTCGATACTTCCGGAA
ACCGAAATGCAAGAAATGCAAGTCGGCCGG|ACAAAATGAAATGCAAGTCGGCCGGCCTAT
AAGGTGGGCGAGGGCAATACATACCCGGCA|GCAAGTCGGCCGGCCTATGCATACGACTTG
GGCCTATGCATACGAGTCATTCGCGTACTA|CATCTAGCTAACAAATAGGTACCTAAATAC
GCAAGTCGGCCGGCCTATGCATACGAGGCC|GAGGGCAATACATACCCGGCACTAAGACCT
AAATGCAAGTCGGCCGGCCTATGCATACGA|CCGCGGTGGTGTATCTGTCGAATTCTTCGA
GGCGAGATCGTCGGGATATGAGAAAGGTGG|ACGAAATCCTCGAAATTGCAAATGCAAGTC
TCCTCATGGCGCAAAGAAGAACAGAGGCCA|CTACGACGGCCTTTACTACACAGTATGATG
GACGAGATCGGATTCGTTACGGGCCCGACT|TTTAAAATGCAAGTCGGCCGGCCTATGCAT
TGCATACGAGTCATTCGCGTACTAGAAGTT|GCTAACAAATAGGTACCTAAATACCCCTCT
CGTGACCATAATACCGAAATGCAAGAAATG|GGTGTGCGAAACACAAAATGAAATGCAAGT
GCGAAACACAAAATGAAATGCAAGTCGGCC|ATACGACTGTTCTGTCCATAAATGCAAGTC
TGCAAGTCGGCCGGCCTATGCATACGACTT|TACACCTAACCACAGGAGTCTCGTAACGCC
GGTACCTAAATACCCCTCTCCAAATGCAAG|CCACGTTACGGTCTATTAGCCTCCTCATGG
CCGGCCTATGCATACGACCTCTGAAATGCA|AACTCTGGTAACGCTTCTACAAACGCTCTA
TTAGTTGGTGAAATGCAAGTCGGCCGGCCT|GAACCTTAAATGCAAGTCGGCCAAATGCAA
TTCGATACTTCCGGAAACTGGTTATACTTG|GGGGCTCTAGAAATCCTGGAGATCACGTGG
CTGTTCTGTCCATAAATGCAAGTCGGCCGG|AGTCGGCCGGCCTATGCATACGAGCAAGTC
CGACTGTTCTGTCCATAAATGCAAGTCGGC|GCAAGTCGGCCGGCCTATGCATACGAGCAA
TGAAATGCAAGTCGGCCGGCCTATGCATAC|AACGCTCTAATCCTCTAGATCAAATAAATG
GCTGGATTAACTCTGGTAACGCTTCTACAA|TCGTAAGAGATTAGTTGGTGAAATGCAAGT
CCTCACCGGACGAGATCGGATTCGTTACGG|TCCCGCAATTTAAAATGCAAGTCGGCCGGC
TATGCATACGAAAGGGGCTCTAGAAATCCT|CACCGGACGAGATCGGATTCGTTACGGGCC
AGAGCCGCTGGTGTGCGAAACACAAAATGA|CGGCCGGCCTATGCATACGACTGTTCTGTC
GGTCGGCCTGTTACGTGACCATAATACCGA|GGTAAGAGCCGCTGGTGTGCGAAACACAAA
GTTACGTGACCATAATACCGAAATGCAAGA|CGCTGGTGTGCGAAACACAAAATGAAATGC
TGGCGAGTCGCTATGTGAGTGCTGGATTAA|GTTCGTTCGGGGAGTGCAATTCGTAAGAGA
GCCGTAAATCGGCACGAAATCCTCGAAATT|AAGTTATACCGGCACCGATGCTTTCAACAT
ATACGACTGTTCTGTCCATAAATGCAAGTC|AATGCAAGTCGGCCGGCCTATGCATACGAG
GAAATGCAAGAAATGCAAGTCGGCCGGCCT|AAATGAAATGCAAGTCGGCCGGCCTATGCA
ATACGAGCAAGTCGGCCGGCCTATGCATAC|CTTCGATACTTCCGGAAACTGGTTATACTT
TATGCATACGATCAACGTGGCGAGTCGCTA|CCGGCCTATGCATACGAGTTCGTTCGGGGA
TGGGATTGTATCCCAGTTGAGCCCCTCAGG|GCAGATTTTCCGGGTGCCGTAAATCGGCAC
GGTGGTGTATCTGTCGAATTCTTCGATACT|ACGAGGCCTATGCATACGAAAGGGGCTCTA
ATACTTGGTTTGCCAAACCGAAGTCACCTA|CACGTGGGATTGTATCCCAGTTGAGCCCCT
TACGAGTCATTCGCGTACTAGAAGTTATAC|ACAAATAGGTACCTAAATACCCCTCTCCAA
TTACGTGACCATAATACCGAAATGCAAGAA|GCTGGTGTGCGAAACACAAAATGAAATGCA
AAATACCCCTCTCCAAATGCAAGTCGGCCG|ACGGTCTATTAGCCTCCTCATGGCGCAAAG
TACGAAAATGCAAGTCGGCCGGCCTATGCA|CTATGTGAGTGCTGGATTAACTCTGGTAAC
CCCTCAGGCGAGATCGTCGGGATATGAGAA|ATCGGCACGAAATCCTCGAAATTGCAAATG
CAATTTAAAATGCAAGTCGGCCGGCCTATG|CGGAAGGTGAGCATTTACGGGACATCTAGC
ATACTTCCGGAAACTGGTTATACTTGGTTT|CTCTAGAAATCCTGGAGATCACGTGGGATT
TCGGCCGGCCTATGCATACGAGTCATTCGC|ACGGGACATCTAGCTAACAAATAGGTACCT
TTTGCGTGAGGTAAGAGCCGCTGGTGTGCG|CTGAAATGCAAGTCGGCCGGCCTATGCATA
AGAAATCCTGGAGATCACGTGGGATTGTAT|TTACGGGCCCGACTGTCATGCAGATTTTCC
AGTCGGCCGGCCTATGCATACGAGGCCTAT|GGCAATACATACCCGGCACTAAGACCTCAC
CCAAATGCAAGTCGGCCGGCCTATGCATAC|CCTCCTCATGGCGCAAAGAAGAACAGAGGC
TCAATTAACTGCCACGTTACGGTCTATTAG|GTGTCATATATAAGCGTTACTCCTCCTGCG
GCATACGACTGTTCTGTCCATAAATGCAAG|TAAATGCAAGTCGGCCGGCCTATGCATACG
GCCTATGCATACGAAAGGGGCTCTAGAAAT|CCTCACCGGACGAGATCGGATTCGTTACGG
CGGCCTATGCATACGACGGCCCGCGGTGGT|ATGCAAGTCGGCCGGCCTATGCATACGAGG
CGAAAATGCAAGTCGGCCGGCCTATGCATA|ATGTGAGTGCTGGATTAACTCTGGTAACGC
CAAGTCGGCCGGCCTATGCATACGATCGGC|CGGCCGGCCTATGCATACGACAAGTCGGCC
GCCTATGCATACGACAAGTCGGCCGGCCTA|GCCGGCCTATGCATACGATCAACGTGGCGA
CCGGAAACTGGTTATACTTGGTTTGCCAAA|AAATCCTGGAGATCACGTGGGATTGTATCC
GGCCGGCCTATGCATACGAAAACACAATGC|GCCGGCCTATGCATACGAAAATGCAAGTCG
CGGCCGGCCTATGCATACGATCGGCCGGCC|GGCCTATGCATACGACAAGTCGGCCGGCCT
TATCTTAACTGGGCTTTGCGTGAGGTAAGA|TATGCATACGACCTCTGAAATGCAAGTCGG
CATACGAAAGGGGCTCTAGAAATCCTGGAG|GGACGAGATCGGATTCGTTACGGGCCCGAC
CATACCCGGCACTAAGACCTCACCGGACGA|CATACGACTTGGCCGTGTCCCGCAATTTAA
CTTCTACAAACGCTCTAATCCTCTAGATCA|AATGCAAGTCGGCCGGCCTATGCATACGAC
TATACCGGCACCGATGCTTTCAACATGTTG|TCCAAATGCAAGTCGGCCGGCCTATGCATA
GAGTGCAATTCGTAAGAGATTAGTTGGTGA|GAAGTCACCTAAGCGGTAGGAACCTTAAAT
TAGCTAACAAATAGGTACCTAAATACCCCT|TATCAATTAACTGCCACGTTACGGTCTATT
TTTGCCAAACCGAAGTCACCTAAGCGGTAG|ATTGTATCCCAGTTGAGCCCCTCAGGCGAG
TAAGAGCCGCTGGTGTGCGAAACACAAAAT|GTCGGCCGGCCTATGCATACGACTGTTCTG
CAAGTCGGCCGGCCTATGCATACGAGTTCG|ACTTCCGGAAACTGGTTATACTTGGTTTGC
AAGAGCCGCTGGTGTGCGAAACACAAAATG|TCGGCCGGCCTATGCATACGACTGTTCTGT
TAAGCGGTAGGAACCTTAAATGCAAGTCGG|CTCAGGCGAGATCGTCGGGATATGAGAAAG
GCCGGCCTATGCATACGAGCAAGTCGGCCG|ATCTGTCGAATTCTTCGATACTTCCGGAAA
CATACGACTTGGCCGTGTCCCGCAATTTAA|TCGTAACGCCATGAATTTTCCTCGGAAGGT
TACGACGGCCCGCGGTGGTGTATCTGTCGA|CCGGCCTATGCATACGAGGCCTATGCATAC
TAAGAGATTAGTTGGTGAAATGCAAGTCGG|GCGGTAGGAACCTTAAATGCAAGTCGGCCA
AAATGCAAGTCGGCCGGCCTATGCATACGA|TGAGCATTTACGGGACATCTAGCTAACAAA
GGAGTGCAATTCGTAAGAGATTAGTTGGTG|CGAAGTCACCTAAGCGGTAGGAACCTTAAA
CGGCCGGCCTATGCATACGACTGTTCTGTC|CTCTAGATCAAATAAATGCAAGTCGGCCGG
GTCGCTATGTGAGTGCTGGATTAACTCTGG|TCGGGGAGTGCAATTCGTAAGAGATTAGTT
GGAGTCTCGTAACGCCATGAATTTTCCTCG|CAAAGACACACCAATCTAGAGCGATCTATA
GACCTCACCGGACGAGATCGGATTCGTTAC|TGTCCCGCAATTTAAAATGCAAGTCGGCCG
GAAATTGCAAATGCAAGTCGGCCGGCCTAT|CAACATGTTGCTACACCTAACCACAGGAGT
CAGATTTTCCGGGTGCCGTAAATCGGCACG|CATTCGCGTACTAGAAGTTATACCGGCACC
TACGACTGTTCTGTCCATAAATGCAAGTCG|ATGCAAGTCGGCCGGCCTATGCATACGAGC
TCGGCCGGCCTATGCATACGACAAGTCGGC|CAAGTCGGCCGGCCTATGCATACGATCAAC
GACTGTTCTGTCCATAAATGCAAGTCGGCC|CAAGTCGGCCGGCCTATGCATACGAGCAAG
TGCTACACCTAACCACAGGAGTCTCGTAAC|TACGAGAGTGTTTTAGGCAAAGACACACCA
TGCATACGAAAGGGGCTCTAGAAATCCTGG|CCGGACGAGATCGGATTCGTTACGGGCCCG
CATACGAGTTCGTTCGGGGAGTGCAATTCG|TACTTGGTTTGCCAAACCGAAGTCACCTAA
GTTCGGGGAGTGCAATTCGTAAGAGATTAG|CCAAACCGAAGTCACCTAAGCGGTAGGAAC
GCCCGCGGTGGTGTATCTGTCGAATTCTTC|ATGCATACGAGGCCTATGCATACGAAAGGG
ACTGCCACGTTACGGTCTATTAGCCTCCTC|ATATAAGCGTTACTCCTCCTGCGCCCTACG
AAATCCTGGAGATCACGTGGGATTGTATCC|ACGGGCCCGACTGTCATGCAGATTTTCCGG
CCTTAAATGCAAGTCGGCCAAATGCAAGTC|GTCGGGATATGAGAAAGGTGGGCGAGGGCA
GGTAGGAACCTTAAATGCAAGTCGGCCAAA|GCGAGATCGTCGGGATATGAGAAAGGTGGG
CTGTCGAATTCTTCGATACTTCCGGAAACT|TGCATACGAAAGGGGCTCTAGAAATCCTGG
CGTAAATCGGCACGAAATCCTCGAAATTGC|GTTATACCGGCACCGATGCTTTCAACATGT
TATGCATACGACGGCCCGCGGTGGTGTATC|AGTCGGCCGGCCTATGCATACGAGGCCTAT
CGTGTCCCGCAATTTAAAATGCAAGTCGGC|AATTTTCCTCGGAAGGTGAGCATTTACGGG
TAGGCAAAGACACACCAATCTAGAGCGATC|GGGGCTACCCGTGCTGTCAGCCCTCCGAAT
AAGTCGGCCGGCCTATGCATACGATCGGCC|GGCCGGCCTATGCATACGACAAGTCGGCCG
CGAGGGCAATACATACCCGGCACTAAGACC|GCCGGCCTATGCATACGACTTGGCCGTGTC
CCTCATGGCGCAAAGAAGAACAGAGGCCAC|TACGACGGCCTTTACTACACAGTATGATGT
GGATTAACTCTGGTAACGCTTCTACAAACG|TAAGAGATTAGTTGGTGAAATGCAAGTCGG
GTGTATCTGTCGAATTCTTCGATACTTCCG|GGCCTATGCATACGAAAGGGGCTCTAGAAA
GCAAGTCGGCCGGCCTATGCATACGATCGG|TCGGCCGGCCTATGCATACGACAAGTCGGC
GCCTATGCATACGATCAACGTGGCGAGTCG|CGGCCGGCCTATGCATACGAGTTCGTTCGG
AGTCGGCCGGCCTATGCATACGACAAGTCG|TGCAAGTCGGCCGGCCTATGCATACGATCA
GCTTCTACAAACGCTCTAATCCTCTAGATC|AAATGCAAGTCGGCCGGCCTATGCATACGA
CGATGCTTTCAACATGTTGCTACACCTAAC|GTCGGCCGGCCTATGCATACGAGAGTGTTT
TGGTTATACTTGGTTTGCCAAACCGAAGTC|GAGATCACGTGGGATTGTATCCCAGTTGAG
ATGCATACGAAAACACAATGCGCGGCATTA|TGCATACGAAAATGCAAGTCGGCCGGCCTA
TCCTCGAAATTGCAAATGCAAGTCGGCCGG|GCTTTCAACATGTTGCTACACCTAACCACA
AAGTCGGCCGGCCTATGCATACGACAAGTC|ATGCAAGTCGGCCGGCCTATGCATACGATC
CCGGCCTATGCATACGATCAACGTGGCGAG|AGTCGGCCGGCCTATGCATACGAGTTCGTT
AATGCAAGTCGGCCGGCCTATGCATACGAC|GCTCTAATCCTCTAGATCAAATAAATGCAA
GCATACGACTTGGCCGTGTCCCGCAATTTA|CTCGTAACGCCATGAATTTTCCTCGGAAGG
GTCGGCCTGTTACGTGACCATAATACCGAA|GTAAGAGCCGCTGGTGTGCGAAACACAAAA
CTATGCATACGACAAGTCGGCCGGCCTATG|CGGCCTATGCATACGATCAACGTGGCGAGT
TGCAAGTCGGCCGGCCTATGCATACGACTG|TCTAATCCTCTAGATCAAATAAATGCAAGT
ATCAACGTGGCGAGTCGCTATGTGAGTGCT|CATACGAGTTCGTTCGGGGAGTGCAATTCG
AGCGATCTATATGTGATGAGTCATGACTGA|TCCGAATATGTCAAAATCAAGGTTGTAAAC
CCTCTGAAATGCAAGTCGGCCGGCCTATGC|TACAAACGCTCTAATCCTCTAGATCAAATA
ACGGCCCGCGGTGGTGTATCTGTCGAATTC|CCTATGCATACGAGGCCTATGCATACGAAA
AAGTCGGCCGGCCTATGCATACGACCTCTG|CTGGATTAACTCTGGTAACGCTTCTACAAA
ACGATCGGCCGGCCTATGCATACGAAAACA|AAGTCGGCCGGCCTATGCATACGAAAATGC
ATCCTGGAGATCACGTGGGATTGTATCCCA|GGGCCCGACTGTCATGCAGATTTTCCGGGT
AGTGTTTTAGGCAAAGACACACCAATCTAG|GTGGCGTGGGGCTACCCGTGCTGTCAGCCC
TCTTAACTGGGCTTTGCGTGAGGTAAGAGC|TGCATACGACCTCTGAAATGCAAGTCGGCC
TAAATCGGCACGAAATCCTCGAAATTGCAA|TATACCGGCACCGATGCTTTCAACATGTTG
GCATACGAGTCATTCGCGTACTAGAAGTTA|CTAACAAATAGGTACCTAAATACCCCTCTC
GCAGATTTTCCGGGTGCCGTAAATCGGCAC|TCATTCGCGTACTAGAAGTTATACCGGCAC
TAACCACAGGAGTCTCGTAACGCCATGAAT|GTTTTAGGCAAAGACACACCAATCTAGAGC
TGTATCCCAGTTGAGCCCCTCAGGCGAGAT|TTTCCGGGTGCCGTAAATCGGCACGAAATC
CTATATCAACCCATAGTACTGAAGGTCGGC|TATCTTAACTGGGCTTTGCGTGAGGTAAGA
GAAGTCACCTAAGCGGTAGGAACCTTAAAT|GTTGAGCCCCTCAGGCGAGATCGTCGGGAT
ACAAGTCGGCCGGCCTATGCATACGAAAAT|TACGATCAACGTGGCGAGTCGCTATGTGAG
AATTAACTGCCACGTTACGGTCTATTAGCC|GTCATATATAAGCGTTACTCCTCCTGCGCC
GTCGGCCGGCCTATGCATACGAGAGTGTTT|GCGCAAAGAAGAACAGAGGCCACGTGGCGT
CGGGACATCTAGCTAACAAATAGGTACCTA|CTGAGGCTTTATCAATTAACTGCCACGTTA
CTAGATCAAATAAATGCAAGTCGGCCGGCC|CATACGACGGCCCGCGGTGGTGTATCTGTC
ACAATGCGCGGCATTATCTTAACTGGGCTT|CAAGTCGGCCGGCCTATGCATACGACCTCT
GGACGAGATCGGATTCGTTACGGGCCCGAC|ATTTAAAATGCAAGTCGGCCGGCCTATGCA
CGGCCGGCCTATGCATACGAGGCCTATGCA|AATACATACCCGGCACTAAGACCTCACCGG
GGCCAAATGCAAGTCGGCCGGCCTATGCAT|AGGTGGGCGAGGGCAATACATACCCGGCAC
CAAAATGAAATGCAAGTCGGCCGGCCTATG|GTTCTGTCCATAAATGCAAGTCGGCCGGCC
AGATCAAATAAATGCAAGTCGGCCGGCCTA|TACGACGGCCCGCGGTGGTGTATCTGTCGA
AGTCGGCCGGCCTATGCATACGAGTCATTC|TTACGGGACATCTAGCTAACAAATAGGTAC
TGTCCATAAATGCAAGTCGGCCGGCCTATG|CCGGCCTATGCATACGAGCAAGTCGGCCGG
CAAGTCGGCCGGCCTATGCATACGAAAATG|ACGATCAACGTGGCGAGTCGCTATGTGAGT
GTCACCTAAGCGGTAGGAACCTTAAATGCA|GAGCCCCTCAGGCGAGATCGTCGGGATATG
GCAAGAAATGCAAGTCGGCCGGCCTATGCA|AAATGCAAGTCGGCCGGCCTATGCATACGA
CGGGTGCCGTAAATCGGCACGAAATCCTCG|ACTAGAAGTTATACCGGCACCGATGCTTTC
ATGACTGAGGCTTTATCAATTAACTGCCAC|TTGTAAACGACATCTGTGTCATATATAAGC
GGCCTATGCATACGATCAACGTGGCGAGTC|TCGGCCGGCCTATGCATACGAGTTCGTTCG
AATGCAAGTCGGCCGGCCTATGCATACGAG|GAGCATTTACGGGACATCTAGCTAACAAAT
AACATGTTGCTACACCTAACCACAGGAGTC|CTATGCATACGAGAGTGTTTTAGGCAAAGA
ATTAACTGCCACGTTACGGTCTATTAGCCT|TCATATATAAGCGTTACTCCTCCTGCGCCC
AGTCGCTATGTGAGTGCTGGATTAACTCTG|TTCGGGGAGTGCAATTCGTAAGAGATTAGT
ATACCCGGCACTAAGACCTCACCGGACGAG|ATACGACTTGGCCGTGTCCCGCAATTTAAA
GAGAGTGTTTTAGGCAAAGACACACCAATC|CACGTGGCGTGGGGCTACCCGTGCTGTCAG
GCCATGAATTTTCCTCGGAAGGTGAGCATT|ATCTAGAGCGATCTATATGTGATGAGTCAT
GTAAGAGCCGCTGGTGTGCGAAACACAAAA|AGTCGGCCGGCCTATGCATACGACTGTTCT
TTAACTGCCACGTTACGGTCTATTAGCCTC|CATATATAAGCGTTACTCCTCCTGCGCCCT
GTCGGCCGGCCTATGCATACGACCTCTGAA|GGATTAACTCTGGTAACGCTTCTACAAACG
CGAAAGGGGCTCTAGAAATCCTGGAGATCA|GAGATCGGATTCGTTACGGGCCCGACTGTC
CATGCAGATTTTCCGGGTGCCGTAAATCGG|GAGTCATTCGCGTACTAGAAGTTATACCGG
GAAGGTGAGCATTTACGGGACATCTAGCTA|TGTGATGAGTCATGACTGAGGCTTTATCAA
AGATTAGTTGGTGAAATGCAAGTCGGCCGG|TAGGAACCTTAAATGCAAGTCGGCCAAATG
AGGTGAGCATTTACGGGACATCTAGCTAAC|TGATGAGTCATGACTGAGGCTTTATCAATT
GGCATTATCTTAACTGGGCTTTGCGTGAGG|CGGCCTATGCATACGACCTCTGAAATGCAA
GCCTATGCATACGAGAGTGTTTTAGGCAAA|AAGAACAGAGGCCACGTGGCGTGGGGCTAC
GCCTCCTCATGGCGCAAAGAAGAACAGAGG|GCCCTACGACGGCCTTTACTACACAGTATG
ACGAAAGGGGCTCTAGAAATCCTGGAGATC|CGAGATCGGATTCGTTACGGGCCCGACTGT
GTTCTGTCCATAAATGCAAGTCGGCCGGCC|TCGGCCGGCCTATGCATACGAGCAAGTCGG
AGATTTTCCGGGTGCCGTAAATCGGCACGA|ATTCGCGTACTAGAAGTTATACCGGCACCG
CTTTGCGTGAGGTAAGAGCCGCTGGTGTGC|TCTGAAATGCAAGTCGGCCGGCCTATGCAT
TATCAATTAACTGCCACGTTACGGTCTATT|CTGTGTCATATATAAGCGTTACTCCTCCTG
ATCAACCCATAGTACTGAAGGTCGGCCTGT|TTAACTGGGCTTTGCGTGAGGTAAGAGCCG
AAGTCGGCCGGCCTATGCATACGAGTTCGT|CTTCCGGAAACTGGTTATACTTGGTTTGCC
AGGGGCTCTAGAAATCCTGGAGATCACGTG|TCGGATTCGTTACGGGCCCGACTGTCATGC
GAAATGCAAGTCGGCCGGCCTATGCATACG|TCCATAAATGCAAGTCGGCCGGCCTATGCA
GCTATGTGAGTGCTGGATTAACTCTGGTAA|GGGAGTGCAATTCGTAAGAGATTAGTTGGT
CCGGCCTATGCATACGACTTGGCCGTGTCC|CACAGGAGTCTCGTAACGCCATGAATTTTC
TACGATCAACGTGGCGAGTCGCTATGTGAG|TATGCATACGAGTTCGTTCGGGGAGTGCAA
TCGGCCGGCCTATGCATACGATCGGCCGGC|CGGCCTATGCATACGACAAGTCGGCCGGCC
CGGCCTATGCATACGAGCAAGTCGGCCGGC|CTGTCGAATTCTTCGATACTTCCGGAAACT
GCTACACCTAACCACAGGAGTCTCGTAACG|ACGAGAGTGTTTTAGGCAAAGACACACCAA
CTCAGGCGAGATCGTCGGGATATGAGAAAG|CGGCACGAAATCCTCGAAATTGCAAATGCA
CCGGCCTATGCATACGATCGGCCGGCCTAT|CTATGCATACGACAAGTCGGCCGGCCTATG
TCCGGGTGCCGTAAATCGGCACGAAATCCT|GTACTAGAAGTTATACCGGCACCGATGCTT
CCGGACGAGATCGGATTCGTTACGGGCCCG|CAATTTAAAATGCAAGTCGGCCGGCCTATG
ATCGGATTCGTTACGGGCCCGACTGTCATG|ATGCAAGTCGGCCGGCCTATGCATACGAGT
GTCGGCCGGCCTATGCATACGAGGCCTATG|GCAATACATACCCGGCACTAAGACCTCACC
AAATGCAAGTCGGCCGGCCTATGCATACGA|CAAGTCGGCCGGCCTATGCATACGACAAGT
GGCCGGCCTATGCATACGACGGCCCGCGGT|CAAATGCAAGTCGGCCGGCCTATGCATACG
CCAAACCGAAGTCACCTAAGCGGTAGGAAC|TATCCCAGTTGAGCCCCTCAGGCGAGATCG
AAAACACAATGCGCGGCATTATCTTAACTG|AAATGCAAGTCGGCCGGCCTATGCATACGA
GCAATTTAAAATGCAAGTCGGCCGGCCTAT|TCGGAAGGTGAGCATTTACGGGACATCTAG
ACACAAAATGAAATGCAAGTCGGCCGGCCT|ACTGTTCTGTCCATAAATGCAAGTCGGCCG
TCTATTAGCCTCCTCATGGCGCAAAGAAGA|CTCCTGCGCCCTACGACGGCCTTTACTACA
GTCGGCCGGCCTATGCATACGAAAATGCAA|ATCAACGTGGCGAGTCGCTATGTGAGTGCT
GCATACGAAAATGCAAGTCGGCCGGCCTAT|TCGCTATGTGAGTGCTGGATTAACTCTGGT
GGCCGGCCTATGCATACGATCGGCCGGCCT|GCCTATGCATACGACAAGTCGGCCGGCCTA
TCCATAAATGCAAGTCGGCCGGCCTATGCA|GGCCTATGCATACGAGCAAGTCGGCCGGCC
CGACCTCTGAAATGCAAGTCGGCCGGCCTA|TTCTACAAACGCTCTAATCCTCTAGATCAA
ACGAGTTCGTTCGGGGAGTGCAATTCGTAA|TTGGTTTGCCAAACCGAAGTCACCTAAGCG
TGCATACGAAAACACAATGCGCGGCATTAT|GCATACGAAAATGCAAGTCGGCCGGCCTAT
GCGAGTCGCTATGTGAGTGCTGGATTAACT|TCGTTCGGGGAGTGCAATTCGTAAGAGATT
GGCCTATGCATACGATCGGCCGGCCTATGC|ATGCATACGACAAGTCGGCCGGCCTATGCA
GGCCGGCCTATGCATACGAGAGTGTTTTAG|CAAAGAAGAACAGAGGCCACGTGGCGTGGG
CAAGTCGGCCGGCCTATGCATACGACCTCT|GCTGGATTAACTCTGGTAACGCTTCTACAA
CATAAATGCAAGTCGGCCGGCCTATGCATA|CCTATGCATACGAGCAAGTCGGCCGGCCTA
AAATGCAAGTCGGCCGGCCTATGCATACGA|TGCTACACCTAACCACAGGAGTCTCGTAAC
CCGATGCTTTCAACATGTTGCTACACCTAA|AGTCGGCCGGCCTATGCATACGAGAGTGTT
CCCAGTTGAGCCCCTCAGGCGAGATCGTCG|GGGTGCCGTAAATCGGCACGAAATCCTCGA
TGGTGAAATGCAAGTCGGCCGGCCTATGCA|TTAAATGCAAGTCGGCCAAATGCAAGTCGG
CTCTAATCCTCTAGATCAAATAAATGCAAG|CCGGCCTATGCATACGACGGCCCGCGGTGG
CGGCCTATGCATACGACCTCTGAAATGCAA|ACTCTGGTAACGCTTCTACAAACGCTCTAA
TGCAAGTCGGCCGGCCTATGCATACGATCG|GTCGGCCGGCCTATGCATACGACAAGTCGG
CATACGATCAACGTGGCGAGTCGCTATGTG|CCTATGCATACGAGTTCGTTCGGGGAGTGC
AGGTGGGCGAGGGCAATACATACCCGGCAC|CAAGTCGGCCGGCCTATGCATACGACTTGG
CCGGCCTATGCATACGAGAGTGTTTTAGGC|AAGAAGAACAGAGGCCACGTGGCGTGGGGC
CGCAATTTAAAATGCAAGTCGGCCGGCCTA|CTCGGAAGGTGAGCATTTACGGGACATCTA
CGAAATTGCAAATGCAAGTCGGCCGGCCTA|TCAACATGTTGCTACACCTAACCACAGGAG
GGATTCGTTACGGGCCCGACTGTCATGCAG|CAAGTCGGCCGGCCTATGCATACGAGTCAT
TCGAATTCTTCGATACTTCCGGAAACTGGT|ATACGAAAGGGGCTCTAGAAATCCTGGAGA
GATCACGTGGGATTGTATCCCAGTTGAGCC|CTGTCATGCAGATTTTCCGGGTGCCGTAAA
AGCCTCCTCATGGCGCAAAGAAGAACAGAG|CGCCCTACGACGGCCTTTACTACACAGTAT
GGCGAGTCGCTATGTGAGTGCTGGATTAAC|TTCGTTCGGGGAGTGCAATTCGTAAGAGAT
CAAACGCTCTAATCCTCTAGATCAAATAAA|AGTCGGCCGGCCTATGCATACGACGGCCCG
CGGCCTATGCATACGAAAACACAATGCGCG|GGCCTATGCATACGAAAATGCAAGTCGGCC
AACCTTAAATGCAAGTCGGCCAAATGCAAG|TCGTCGGGATATGAGAAAGGTGGGCGAGGG
GCATACGACCTCTGAAATGCAAGTCGGCCG|AACGCTTCTACAAACGCTCTAATCCTCTAG
CGACTGTCATGCAGATTTTCCGGGTGCCGT|TGCATACGAGTCATTCGCGTACTAGAAGTT
CGATCGGCCGGCCTATGCATACGAAAACAC|AGTCGGCCGGCCTATGCATACGAAAATGCA
TTATACCGGCACCGATGCTTTCAACATGTT|CTCCAAATGCAAGTCGGCCGGCCTATGCAT
AATCTAGAGCGATCTATATGTGATGAGTCA|TCAGCCCTCCGAATATGTCAAAATCAAGGT
TGCAAGTCGGCCGGCCTATGCATACGAGGC|CGAGGGCAATACATACCCGGCACTAAGACC
CTAAGCGGTAGGAACCTTAAATGCAAGTCG|CCTCAGGCGAGATCGTCGGGATATGAGAAA
ACCAATCTAGAGCGATCTATATGTGATGAG|CTGTCAGCCCTCCGAATATGTCAAAATCAA
GTGCAATTCGTAAGAGATTAGTTGGTGAAA|AGTCACCTAAGCGGTAGGAACCTTAAATGC
CGTAACGCCATGAATTTTCCTCGGAAGGTG|ACACCAATCTAGAGCGATCTATATGTGATG
GTTATACCGGCACCGATGCTTTCAACATGT|TCTCCAAATGCAAGTCGGCCGGCCTATGCA
CCTATGCATACGAAAATGCAAGTCGGCCGG|GCGAGTCGCTATGTGAGTGCTGGATTAACT
CAAATGCAAGTCGGCCGGCCTATGCATACG|CTCCTCATGGCGCAAAGAAGAACAGAGGCC
GGAGATCACGTGGGATTGTATCCCAGTTGA|CGACTGTCATGCAGATTTTCCGGGTGCCGT
GGCCTATGCATACGAGTTCGTTCGGGGAGT|ACTGGTTATACTTGGTTTGCCAAACCGAAG
AATGCAAGAAATGCAAGTCGGCCGGCCTAT|ATGAAATGCAAGTCGGCCGGCCTATGCATA
AAATTGCAAATGCAAGTCGGCCGGCCTATG|AACATGTTGCTACACCTAACCACAGGAGTC
CCGGCCTATGCATACGAAAATGCAAGTCGG|CGTGGCGAGTCGCTATGTGAGTGCTGGATT
CGAATTCTTCGATACTTCCGGAAACTGGTT|TACGAAAGGGGCTCTAGAAATCCTGGAGAT
ACCCGGCACTAAGACCTCACCGGACGAGAT|ACGACTTGGCCGTGTCCCGCAATTTAAAAT
CATACGAGTCATTCGCGTACTAGAAGTTAT|TAACAAATAGGTACCTAAATACCCCTCTCC
ACCGAAGTCACCTAAGCGGTAGGAACCTTA|CCAGTTGAGCCCCTCAGGCGAGATCGTCGG
CAAATAAATGCAAGTCGGCCGGCCTATGCA|ACGGCCCGCGGTGGTGTATCTGTCGAATTC
CAATTAACTGCCACGTTACGGTCTATTAGC|TGTCATATATAAGCGTTACTCCTCCTGCGC
GCAAGTCGGCCAAATGCAAGTCGGCCGGCC|ATGAGAAAGGTGGGCGAGGGCAATACATAC
CTGAAGGTCGGCCTGTTACGTGACCATAAT|CGTGAGGTAAGAGCCGCTGGTGTGCGAAAC
TTCAACATGTTGCTACACCTAACCACAGGA|GGCCTATGCATACGAGAGTGTTTTAGGCAA
TACGAAAGGGGCTCTAGAAATCCTGGAGAT|ACGAGATCGGATTCGTTACGGGCCCGACTG
TACGTGACCATAATACCGAAATGCAAGAAA|CTGGTGTGCGAAACACAAAATGAAATGCAA
ACCCCTCTCCAAATGCAAGTCGGCCGGCCT|TCTATTAGCCTCCTCATGGCGCAAAGAAGA
GTGAGGTAAGAGCCGCTGGTGTGCGAAACA|ATGCAAGTCGGCCGGCCTATGCATACGACT
ATGCATACGACGGCCCGCGGTGGTGTATCT|GTCGGCCGGCCTATGCATACGAGGCCTATG
CAAGTCGGCCGGCCTATGCATACGACGGCC|GTCGGCCAAATGCAAGTCGGCCGGCCTATG
GCCTATGCATACGACCTCTGAAATGCAAGT|TCTGGTAACGCTTCTACAAACGCTCTAATC
TACGATCGGCCGGCCTATGCATACGAAAAC|CAAGTCGGCCGGCCTATGCATACGAAAATG
CATACGACGGCCCGCGGTGGTGTATCTGTC|GGCCGGCCTATGCATACGAGGCCTATGCAT
GCATACGATCAACGTGGCGAGTCGCTATGT|GCCTATGCATACGAGTTCGTTCGGGGAGTG
ATACGAGAGTGTTTTAGGCAAAGACACACC|AGGCCACGTGGCGTGGGGCTACCCGTGCTG
TGCCAAACCGAAGTCACCTAAGCGGTAGGA|TGTATCCCAGTTGAGCCCCTCAGGCGAGAT
TGAGTCATGACTGAGGCTTTATCAATTAAC|TCAAGGTTGTAAACGACATCTGTGTCATAT
GTTACGGTCTATTAGCCTCCTCATGGCGCA|GTTACTCCTCCTGCGCCCTACGACGGCCTT
CGGCCTATGCATACGACTGTTCTGTCCATA|AGATCAAATAAATGCAAGTCGGCCGGCCTA
TAGAAATCCTGGAGATCACGTGGGATTGTA|GTTACGGGCCCGACTGTCATGCAGATTTTC
ACACCTAACCACAGGAGTCTCGTAACGCCA|AGAGTGTTTTAGGCAAAGACACACCAATCT
ACCCATAGTACTGAAGGTCGGCCTGTTACG|CTGGGCTTTGCGTGAGGTAAGAGCCGCTGG
TTCCGGGTGCCGTAAATCGGCACGAAATCC|CGTACTAGAAGTTATACCGGCACCGATGCT
TATCCCAGTTGAGCCCCTCAGGCGAGATCG|TCCGGGTGCCGTAAATCGGCACGAAATCCT
CTATGCATACGACCTCTGAAATGCAAGTCG|TGGTAACGCTTCTACAAACGCTCTAATCCT
AGAAAGGTGGGCGAGGGCAATACATACCCG|AATGCAAGTCGGCCGGCCTATGCATACGAC
GTGAGCATTTACGGGACATCTAGCTAACAA|ATGAGTCATGACTGAGGCTTTATCAATTAA
CATGGCGCAAAGAAGAACAGAGGCCACGTG|GACGGCCTTTACTACACAGTATGATGTATG
TAAGACCTCACCGGACGAGATCGGATTCGT|CCGTGTCCCGCAATTTAAAATGCAAGTCGG
CCGAAGTCACCTAAGCGGTAGGAACCTTAA|CAGTTGAGCCCCTCAGGCGAGATCGTCGGG
CGGCACCGATGCTTTCAACATGTTGCTACA|ATGCAAGTCGGCCGGCCTATGCATACGAGA
TGACTGAGGCTTTATCAATTAACTGCCACG|TGTAAACGACATCTGTGTCATATATAAGCG
ATCAAATAAATGCAAGTCGGCCGGCCTATG|CGACGGCCCGCGGTGGTGTATCTGTCGAAT
AAAATGAAATGCAAGTCGGCCGGCCTATGC|TTCTGTCCATAAATGCAAGTCGGCCGGCCT
GCAAGTCGGCCGGCCTATGCATACGAGAGT|CATGGCGCAAAGAAGAACAGAGGCCACGTG
AACGCTTCTACAAACGCTCTAATCCTCTAG|GTGAAATGCAAGTCGGCCGGCCTATGCATA
ATGCAAGTCGGCCAAATGCAAGTCGGCCGG|ATATGAGAAAGGTGGGCGAGGGCAATACAT
ATACATACCCGGCACTAAGACCTCACCGGA|ATGCATACGACTTGGCCGTGTCCCGCAATT
TTCTACAAACGCTCTAATCCTCTAGATCAA|ATGCAAGTCGGCCGGCCTATGCATACGACG
TGGCCGTGTCCCGCAATTTAAAATGCAAGT|CATGAATTTTCCTCGGAAGGTGAGCATTTA
ACACAATGCGCGGCATTATCTTAACTGGGC|TGCAAGTCGGCCGGCCTATGCATACGACCT
TCGGCCGGCCTATGCATACGAGAGTGTTTT|CGCAAAGAAGAACAGAGGCCACGTGGCGTG
GCCGGCCTATGCATACGAGGCCTATGCATA|TACATACCCGGCACTAAGACCTCACCGGAC
TCGGCCGGCCTATGCATACGAGTTCGTTCG|CCGGAAACTGGTTATACTTGGTTTGCCAAA
TGAATTTTCCTCGGAAGGTGAGCATTTACG|AGAGCGATCTATATGTGATGAGTCATGACT
GTCGGCCGGCCTATGCATACGAGTCATTCG|TACGGGACATCTAGCTAACAAATAGGTACC
AAATAGGTACCTAAATACCCCTCTCCAAAT|AACTGCCACGTTACGGTCTATTAGCCTCCT
GTGTTTTAGGCAAAGACACACCAATCTAGA|TGGCGTGGGGCTACCCGTGCTGTCAGCCCT
GTTGCTACACCTAACCACAGGAGTCTCGTA|CATACGAGAGTGTTTTAGGCAAAGACACAC
ACGACAAGTCGGCCGGCCTATGCATACGAA|GCATACGATCAACGTGGCGAGTCGCTATGT
ATGCGCGGCATTATCTTAACTGGGCTTTGC|GTCGGCCGGCCTATGCATACGACCTCTGAA
TATTAGCCTCCTCATGGCGCAAAGAAGAAC|CCTGCGCCCTACGACGGCCTTTACTACACA
CGCTTCTACAAACGCTCTAATCCTCTAGAT|GAAATGCAAGTCGGCCGGCCTATGCATACG
GACCATAATACCGAAATGCAAGAAATGCAA|GTGCGAAACACAAAATGAAATGCAAGTCGG
GGCCCGACTGTCATGCAGATTTTCCGGGTG|CCTATGCATACGAGTCATTCGCGTACTAGA
GAAAATGCAAGTCGGCCGGCCTATGCATAC|TGTGAGTGCTGGATTAACTCTGGTAACGCT
AGGAACCTTAAATGCAAGTCGGCCAAATGC|AGATCGTCGGGATATGAGAAAGGTGGGCGA
CAAATAGGTACCTAAATACCCCTCTCCAAA|TAACTGCCACGTTACGGTCTATTAGCCTCC
TGTCGAATTCTTCGATACTTCCGGAAACTG|GCATACGAAAGGGGCTCTAGAAATCCTGGA
CCGGCCTATGCATACGACGGCCCGCGGTGG|AATGCAAGTCGGCCGGCCTATGCATACGAG
CACAATGCGCGGCATTATCTTAACTGGGCT|GCAAGTCGGCCGGCCTATGCATACGACCTC
GACTTGGCCGTGTCCCGCAATTTAAAATGC|ACGCCATGAATTTTCCTCGGAAGGTGAGCA
GGCCGGCCTATGCATACGAGTCATTCGCGT|GGGACATCTAGCTAACAAATAGGTACCTAA
GATTCGTTACGGGCCCGACTGTCATGCAGA|AAGTCGGCCGGCCTATGCATACGAGTCATT
CAAGTCGGCCGGCCTATGCATACGATCAAC|TACGAGCAAGTCGGCCGGCCTATGCATACG
AGTCGGCCGGCCTATGCATACGAGTTCGTT|TTCCGGAAACTGGTTATACTTGGTTTGCCA
TTAACTGGGCTTTGCGTGAGGTAAGAGCCG|CATACGACCTCTGAAATGCAAGTCGGCCGG
ACTCTGGTAACGCTTCTACAAACGCTCTAA|ATTAGTTGGTGAAATGCAAGTCGGCCGGCC
ACCTCACCGGACGAGATCGGATTCGTTACG|GTCCCGCAATTTAAAATGCAAGTCGGCCGG
GTGTGCGAAACACAAAATGAAATGCAAGTC|ATGCATACGACTGTTCTGTCCATAAATGCA
GTGGGCGAGGGCAATACATACCCGGCACTA|AGTCGGCCGGCCTATGCATACGACTTGGCC
TAACGCCATGAATTTTCCTCGGAAGGTGAG|ACCAATCTAGAGCGATCTATATGTGATGAG
TATGCATACGAGAGTGTTTTAGGCAAAGAC|AACAGAGGCCACGTGGCGTGGGGCTACCCG
TTAGGCAAAGACACACCAATCTAGAGCGAT|TGGGGCTACCCGTGCTGTCAGCCCTCCGAA
AGTCACCTAAGCGGTAGGAACCTTAAATGC|TGAGCCCCTCAGGCGAGATCGTCGGGATAT
GAATTCTTCGATACTTCCGGAAACTGGTTA|ACGAAAGGGGCTCTAGAAATCCTGGAGATC
CATACGACAAGTCGGCCGGCCTATGCATAC|TATGCATACGATCAACGTGGCGAGTCGCTA
GGTTTGCCAAACCGAAGTCACCTAAGCGGT|GGATTGTATCCCAGTTGAGCCCCTCAGGCG
CTCTAGAAATCCTGGAGATCACGTGGGATT|TTCGTTACGGGCCCGACTGTCATGCAGATT
CCTGTTACGTGACCATAATACCGAAATGCA|AGCCGCTGGTGTGCGAAACACAAAATGAAA
ATCAATTAACTGCCACGTTACGGTCTATTA|TGTGTCATATATAAGCGTTACTCCTCCTGC
GAGGTAAGAGCCGCTGGTGTGCGAAACACA|GCAAGTCGGCCGGCCTATGCATACGACTGT
CATACGAGAGTGTTTTAGGCAAAGACACAC|GAGGCCACGTGGCGTGGGGCTACCCGTGCT
TTCTGTCCATAAATGCAAGTCGGCCGGCCT|CGGCCGGCCTATGCATACGAGCAAGTCGGC
TTGCTACACCTAACCACAGGAGTCTCGTAA|ATACGAGAGTGTTTTAGGCAAAGACACACC
ACTTGGCCGTGTCCCGCAATTTAAAATGCA|CGCCATGAATTTTCCTCGGAAGGTGAGCAT
ACCATAATACCGAAATGCAAGAAATGCAAG|TGCGAAACACAAAATGAAATGCAAGTCGGC
ACGGTCTATTAGCCTCCTCATGGCGCAAAG|ACTCCTCCTGCGCCCTACGACGGCCTTTAC
CTGGTGTGCGAAACACAAAATGAAATGCAA|CCTATGCATACGACTGTTCTGTCCATAAAT
GACCTCTGAAATGCAAGTCGGCCGGCCTAT|TCTACAAACGCTCTAATCCTCTAGATCAAA
CTCTCCAAATGCAAGTCGGCCGGCCTATGC|TTAGCCTCCTCATGGCGCAAAGAAGAACAG
TGCAAGTCGGCCAAATGCAAGTCGGCCGGC|TATGAGAAAGGTGGGCGAGGGCAATACATA
TGCAAGTCGGCCGGCCTATGCATACGAGCA|CGGTGGTGTATCTGTCGAATTCTTCGATAC
TGGATTAACTCTGGTAACGCTTCTACAAAC|GTAAGAGATTAGTTGGTGAAATGCAAGTCG
CCGAAATGCAAGAAATGCAAGTCGGCCGGC|CAAAATGAAATGCAAGTCGGCCGGCCTATG
CGGCCGGCCTATGCATACGACTTGGCCGTG|AACCACAGGAGTCTCGTAACGCCATGAATT
CGAGATCGGATTCGTTACGGGCCCGACTGT|TAAAATGCAAGTCGGCCGGCCTATGCATAC
TTTATCAATTAACTGCCACGTTACGGTCTA|ATCTGTGTCATATATAAGCGTTACTCCTCC
TTCGTAAGAGATTAGTTGGTGAAATGCAAG|CTAAGCGGTAGGAACCTTAAATGCAAGTCG
GTGGCGAGTCGCTATGTGAGTGCTGGATTA|AGTTCGTTCGGGGAGTGCAATTCGTAAGAG
CGCGGCATTATCTTAACTGGGCTTTGCGTG|GGCCGGCCTATGCATACGACCTCTGAAATG
TGAGGTAAGAGCCGCTGGTGTGCGAAACAC|TGCAAGTCGGCCGGCCTATGCATACGACTG
CTCATGGCGCAAAGAAGAACAGAGGCCACG|ACGACGGCCTTTACTACACAGTATGATGTA
TTTCCGGGTGCCGTAAATCGGCACGAAATC|GCGTACTAGAAGTTATACCGGCACCGATGC
ATTTTCCTCGGAAGGTGAGCATTTACGGGA|GCGATCTATATGTGATGAGTCATGACTGAG
CTGGATTAACTCTGGTAACGCTTCTACAAA|CGTAAGAGATTAGTTGGTGAAATGCAAGTC
ATGAGAAAGGTGGGCGAGGGCAATACATAC|GCAAATGCAAGTCGGCCGGCCTATGCATAC
CGTGAGGTAAGAGCCGCTGGTGTGCGAAAC|AATGCAAGTCGGCCGGCCTATGCATACGAC
AAACACAAAATGAAATGCAAGTCGGCCGGC|CGACTGTTCTGTCCATAAATGCAAGTCGGC
GCCTATGCATACGAAAACACAATGCGCGGC|CCTATGCATACGAAAATGCAAGTCGGCCGG
CGAGTCATTCGCGTACTAGAAGTTATACCG|AAATAGGTACCTAAATACCCCTCTCCAAAT
AAGTCGGCCGGCCTATGCATACGAGGCCTA|GGGCAATACATACCCGGCACTAAGACCTCA
CACGAAATCCTCGAAATTGCAAATGCAAGT|CACCGATGCTTTCAACATGTTGCTACACCT
AATCCTGGAGATCACGTGGGATTGTATCCC|CGGGCCCGACTGTCATGCAGATTTTCCGGG
TAATACCGAAATGCAAGAAATGCAAGTCGG|AAACACAAAATGAAATGCAAGTCGGCCGGC
AGGGCAATACATACCCGGCACTAAGACCTC|CGGCCTATGCATACGACTTGGCCGTGTCCC
ATGCATACGACAAGTCGGCCGGCCTATGCA|GCCTATGCATACGATCAACGTGGCGAGTCG
GTCGGCCGGCCTATGCATACGACAAGTCGG|GCAAGTCGGCCGGCCTATGCATACGATCAA
CTATGCATACGATCGGCCGGCCTATGCATA|CATACGACAAGTCGGCCGGCCTATGCATAC
ACATACCCGGCACTAAGACCTCACCGGACG|GCATACGACTTGGCCGTGTCCCGCAATTTA
GAGCATTTACGGGACATCTAGCTAACAAAT|GAGTCATGACTGAGGCTTTATCAATTAACT
AACGCCATGAATTTTCCTCGGAAGGTGAGC|CCAATCTAGAGCGATCTATATGTGATGAGT
CCTCAGGCGAGATCGTCGGGATATGAGAAA|TCGGCACGAAATCCTCGAAATTGCAAATGC
CTGCCACGTTACGGTCTATTAGCCTCCTCA|TATAAGCGTTACTCCTCCTGCGCCCTACGA
ATCTAGCTAACAAATAGGTACCTAAATACC|CTTTATCAATTAACTGCCACGTTACGGTCT
ACGCCATGAATTTTCCTCGGAAGGTGAGCA|CAATCTAGAGCGATCTATATGTGATGAGTC
CTTAACTGGGCTTTGCGTGAGGTAAGAGCC|GCATACGACCTCTGAAATGCAAGTCGGCCG
TTGAGCCCCTCAGGCGAGATCGTCGGGATA|CCGTAAATCGGCACGAAATCCTCGAAATTG
ACGTGACCATAATACCGAAATGCAAGAAAT|TGGTGTGCGAAACACAAAATGAAATGCAAG
ATACGAAAACACAATGCGCGGCATTATCTT|TACGAAAATGCAAGTCGGCCGGCCTATGCA
CCGGCCTATGCATACGACAAGTCGGCCGGC|TCGGCCGGCCTATGCATACGATCAACGTGG
GGGCAATACATACCCGGCACTAAGACCTCA|GGCCTATGCATACGACTTGGCCGTGTCCCG
GCCTATGCATACGACTGTTCTGTCCATAAA|ATCAAATAAATGCAAGTCGGCCGGCCTATG
CCCATAGTACTGAAGGTCGGCCTGTTACGT|TGGGCTTTGCGTGAGGTAAGAGCCGCTGGT
TGCGTGAGGTAAGAGCCGCTGGTGTGCGAA|GAAATGCAAGTCGGCCGGCCTATGCATACG
CCTATATCAACCCATAGTACTGAAGGTCGG|TTATCTTAACTGGGCTTTGCGTGAGGTAAG
GTCGGCCGGCCTATGCATACGACTTGGCCG|CTAACCACAGGAGTCTCGTAACGCCATGAA
ATGCATACGATCAACGTGGCGAGTCGCTAT|CGGCCTATGCATACGAGTTCGTTCGGGGAG
ATGCTTTCAACATGTTGCTACACCTAACCA|CGGCCGGCCTATGCATACGAGAGTGTTTTA
GTTACGGGCCCGACTGTCATGCAGATTTTC|GGCCGGCCTATGCATACGAGTCATTCGCGT
AATCCTCGAAATTGCAAATGCAAGTCGGCC|ATGCTTTCAACATGTTGCTACACCTAACCA
AAGTCGGCCGGCCTATGCATACGAGCAAGT|TGGTGTATCTGTCGAATTCTTCGATACTTC
GGTAACGCTTCTACAAACGCTCTAATCCTC|TTGGTGAAATGCAAGTCGGCCGGCCTATGC
GAAATGCAAGTCGGCCGGCCTATGCATACG|ACGCTCTAATCCTCTAGATCAAATAAATGC
CCTATGCATACGAGGCCTATGCATACGAAA|ACCCGGCACTAAGACCTCACCGGACGAGAT
AAGGTGAGCATTTACGGGACATCTAGCTAA|GTGATGAGTCATGACTGAGGCTTTATCAAT
AGCCCCTCAGGCGAGATCGTCGGGATATGA|TAAATCGGCACGAAATCCTCGAAATTGCAA
GATGAGTCATGACTGAGGCTTTATCAATTA|AATCAAGGTTGTAAACGACATCTGTGTCAT
TGATGAGTCATGACTGAGGCTTTATCAATT|AAATCAAGGTTGTAAACGACATCTGTGTCA
TCGGGGAGTGCAATTCGTAAGAGATTAGTT|AAACCGAAGTCACCTAAGCGGTAGGAACCT
TATGCATACGAGTTCGTTCGGGGAGTGCAA|GTTATACTTGGTTTGCCAAACCGAAGTCAC
CGGCCAAATGCAAGTCGGCCGGCCTATGCA|AAGGTGGGCGAGGGCAATACATACCCGGCA
ATTCTTCGATACTTCCGGAAACTGGTTATA|GAAAGGGGCTCTAGAAATCCTGGAGATCAC
TAATCCTCTAGATCAAATAAATGCAAGTCG|GCCTATGCATACGACGGCCCGCGGTGGTGT
CAAACCGAAGTCACCTAAGCGGTAGGAACC|ATCCCAGTTGAGCCCCTCAGGCGAGATCGT
CCTCTCCAAATGCAAGTCGGCCGGCCTATG|ATTAGCCTCCTCATGGCGCAAAGAAGAACA
AATAGGTACCTAAATACCCCTCTCCAAATG|ACTGCCACGTTACGGTCTATTAGCCTCCTC
GGATTGTATCCCAGTTGAGCCCCTCAGGCG|AGATTTTCCGGGTGCCGTAAATCGGCACGA
AATACCGAAATGCAAGAAATGCAAGTCGGC|AACACAAAATGAAATGCAAGTCGGCCGGCC
CATACGACCTCTGAAATGCAAGTCGGCCGG|ACGCTTCTACAAACGCTCTAATCCTCTAGA
CCTATGCATACGATCAACGTGGCGAGTCGC|GGCCGGCCTATGCATACGAGTTCGTTCGGG
TTCGTTACGGGCCCGACTGTCATGCAGATT|GTCGGCCGGCCTATGCATACGAGTCATTCG
ACTGTCATGCAGATTTTCCGGGTGCCGTAA|CATACGAGTCATTCGCGTACTAGAAGTTAT
CTATGCATACGAAAACACAATGCGCGGCAT|TATGCATACGAAAATGCAAGTCGGCCGGCC
AGTCGGCCGGCCTATGCATACGAAAATGCA|GATCAACGTGGCGAGTCGCTATGTGAGTGC
CGTGGCGAGTCGCTATGTGAGTGCTGGATT|GAGTTCGTTCGGGGAGTGCAATTCGTAAGA
ACCTTAAATGCAAGTCGGCCAAATGCAAGT|CGTCGGGATATGAGAAAGGTGGGCGAGGGC
CCTATGCATACGACCTCTGAAATGCAAGTC|CTGGTAACGCTTCTACAAACGCTCTAATCC
GGGCTCTAGAAATCCTGGAGATCACGTGGG|GGATTCGTTACGGGCCCGACTGTCATGCAG
TTCGGGGAGTGCAATTCGTAAGAGATTAGT|CAAACCGAAGTCACCTAAGCGGTAGGAACC
CTACACCTAACCACAGGAGTCTCGTAACGC|CGAGAGTGTTTTAGGCAAAGACACACCAAT
GGCCTATGCATACGACAAGTCGGCCGGCCT|GGCCGGCCTATGCATACGATCAACGTGGCG
CGAGTTCGTTCGGGGAGTGCAATTCGTAAG|TGGTTTGCCAAACCGAAGTCACCTAAGCGG
GCATACGATCGGCCGGCCTATGCATACGAA|CGACAAGTCGGCCGGCCTATGCATACGAAA
ACGAGCAAGTCGGCCGGCCTATGCATACGA|TCGATACTTCCGGAAACTGGTTATACTTGG
CCACAGGAGTCTCGTAACGCCATGAATTTT|TTAGGCAAAGACACACCAATCTAGAGCGAT
CGGCCGGCCTATGCATACGAAAATGCAAGT|CAACGTGGCGAGTCGCTATGTGAGTGCTGG
AAAATGCAAGTCGGCCGGCCTATGCATACG|GTGAGCATTTACGGGACATCTAGCTAACAA
ACGAGGCCTATGCATACGAAAGGGGCTCTA|TAAGACCTCACCGGACGAGATCGGATTCGT
GCTCTAGAAATCCTGGAGATCACGTGGGAT|ATTCGTTACGGGCCCGACTGTCATGCAGAT
CAAGTCGGCCGGCCTATGCATACGAGGCCT|AGGGCAATACATACCCGGCACTAAGACCTC
CCAAATGCAAGTCGGCCGGCCTATGCATAC|GTGGGCGAGGGCAATACATACCCGGCACTA
TATGCATACGACTTGGCCGTGTCCCGCAAT|AGTCTCGTAACGCCATGAATTTTCCTCGGA
ATTAACTCTGGTAACGCTTCTACAAACGCT|AGAGATTAGTTGGTGAAATGCAAGTCGGCC
CTAGCTAACAAATAGGTACCTAAATACCCC|TTATCAATTAACTGCCACGTTACGGTCTAT
TGCAAGTCGGCCGGCCTATGCATACGACAA|TAAATGCAAGTCGGCCGGCCTATGCATACG
ATTTAAAATGCAAGTCGGCCGGCCTATGCA|GAAGGTGAGCATTTACGGGACATCTAGCTA
TATCAACCCATAGTACTGAAGGTCGGCCTG|CTTAACTGGGCTTTGCGTGAGGTAAGAGCC
CAAGTCGGCCGGCCTATGCATACGACAAGT|AATGCAAGTCGGCCGGCCTATGCATACGAT
ACGAGAGTGTTTTAGGCAAAGACACACCAA|GCCACGTGGCGTGGGGCTACCCGTGCTGTC
TTACGGGCCCGACTGTCATGCAGATTTTCC|GCCGGCCTATGCATACGAGTCATTCGCGTA
GAGATTAGTTGGTGAAATGCAAGTCGGCCG|GTAGGAACCTTAAATGCAAGTCGGCCAAAT
TACGGGCCCGACTGTCATGCAGATTTTCCG|CCGGCCTATGCATACGAGTCATTCGCGTAC
TGCATACGAAAATGCAAGTCGGCCGGCCTA|GTCGCTATGTGAGTGCTGGATTAACTCTGG
ATGCAGATTTTCCGGGTGCCGTAAATCGGC|AGTCATTCGCGTACTAGAAGTTATACCGGC
GTAACGCCATGAATTTTCCTCGGAAGGTGA|CACCAATCTAGAGCGATCTATATGTGATGA
CGTGGGATTGTATCCCAGTTGAGCCCCTCA|ATGCAGATTTTCCGGGTGCCGTAAATCGGC
CGGCCGGCCTATGCATACGATCAACGTGGC|GCAAGTCGGCCGGCCTATGCATACGAGTTC
TGTATCTGTCGAATTCTTCGATACTTCCGG|GCCTATGCATACGAAAGGGGCTCTAGAAAT
ATGCAAGAAATGCAAGTCGGCCGGCCTATG|TGAAATGCAAGTCGGCCGGCCTATGCATAC
CCTCGAAATTGCAAATGCAAGTCGGCCGGC|CTTTCAACATGTTGCTACACCTAACCACAG
CCGCGGTGGTGTATCTGTCGAATTCTTCGA|GCATACGAGGCCTATGCATACGAAAGGGGC
ATACGATCGGCCGGCCTATGCATACGAAAA|ACAAGTCGGCCGGCCTATGCATACGAAAAT
GCATTATCTTAACTGGGCTTTGCGTGAGGT|GGCCTATGCATACGACCTCTGAAATGCAAG
GGCTTTATCAATTAACTGCCACGTTACGGT|GACATCTGTGTCATATATAAGCGTTACTCC
CCCGCAATTTAAAATGCAAGTCGGCCGGCC|TCCTCGGAAGGTGAGCATTTACGGGACATC
GTGAAATGCAAGTCGGCCGGCCTATGCATA|AAATGCAAGTCGGCCAAATGCAAGTCGGCC
CGGTAGGAACCTTAAATGCAAGTCGGCCAA|GGCGAGATCGTCGGGATATGAGAAAGGTGG
GCCGGCCTATGCATACGAGAGTGTTTTAGG|AAAGAAGAACAGAGGCCACGTGGCGTGGGG
GCCAAACCGAAGTCACCTAAGCGGTAGGAA|GTATCCCAGTTGAGCCCCTCAGGCGAGATC
ACGCTTCTACAAACGCTCTAATCCTCTAGA|TGAAATGCAAGTCGGCCGGCCTATGCATAC
CTATATGTGATGAGTCATGACTGAGGCTTT|TATGTCAAAATCAAGGTTGTAAACGACATC
AGAAGTTATACCGGCACCGATGCTTTCAAC|CCCCTCTCCAAATGCAAGTCGGCCGGCCTA
TGCGCGGCATTATCTTAACTGGGCTTTGCG|TCGGCCGGCCTATGCATACGACCTCTGAAA
AGTCATTCGCGTACTAGAAGTTATACCGGC|ATAGGTACCTAAATACCCCTCTCCAAATGC
ATACGAGTTCGTTCGGGGAGTGCAATTCGT|ACTTGGTTTGCCAAACCGAAGTCACCTAAG
GGCTTTGCGTGAGGTAAGAGCCGCTGGTGT|CCTCTGAAATGCAAGTCGGCCGGCCTATGC
GGGATATGAGAAAGGTGGGCGAGGGCAATA|AAATTGCAAATGCAAGTCGGCCGGCCTATG
TACGACAAGTCGGCCGGCCTATGCATACGA|TGCATACGATCAACGTGGCGAGTCGCTATG
TATATGTGATGAGTCATGACTGAGGCTTTA|ATGTCAAAATCAAGGTTGTAAACGACATCT
GTGGGATTGTATCCCAGTTGAGCCCCTCAG|TGCAGATTTTCCGGGTGCCGTAAATCGGCA
CCGCTGGTGTGCGAAACACAAAATGAAATG|CGGCCTATGCATACGACTGTTCTGTCCATA
ACGATCAACGTGGCGAGTCGCTATGTGAGT|ATGCATACGAGTTCGTTCGGGGAGTGCAAT
ATTTACGGGACATCTAGCTAACAAATAGGT|CATGACTGAGGCTTTATCAATTAACTGCCA
AACGTGGCGAGTCGCTATGTGAGTGCTGGA|ACGAGTTCGTTCGGGGAGTGCAATTCGTAA
GTCGGCCAAATGCAAGTCGGCCGGCCTATG|GAAAGGTGGGCGAGGGCAATACATACCCGG
AATACATACCCGGCACTAAGACCTCACCGG|TATGCATACGACTTGGCCGTGTCCCGCAAT
TTGGCCGTGTCCCGCAATTTAAAATGCAAG|CCATGAATTTTCCTCGGAAGGTGAGCATTT
GTCATGCAGATTTTCCGGGTGCCGTAAATC|ACGAGTCATTCGCGTACTAGAAGTTATACC
GAGTTCGTTCGGGGAGTGCAATTCGTAAGA|GGTTTGCCAAACCGAAGTCACCTAAGCGGT
TTTTAGGCAAAGACACACCAATCTAGAGCG|CGTGGGGCTACCCGTGCTGTCAGCCCTCCG
GCACGAAATCCTCGAAATTGCAAATGCAAG|GCACCGATGCTTTCAACATGTTGCTACACC
GTATCCCAGTTGAGCCCCTCAGGCGAGATC|TTCCGGGTGCCGTAAATCGGCACGAAATCC
TGTTACGTGACCATAATACCGAAATGCAAG|CCGCTGGTGTGCGAAACACAAAATGAAATG
GGGGAGTGCAATTCGTAAGAGATTAGTTGG|ACCGAAGTCACCTAAGCGGTAGGAACCTTA
GAAAACACAATGCGCGGCATTATCTTAACT|AAAATGCAAGTCGGCCGGCCTATGCATACG
CCGACTGTCATGCAGATTTTCCGGGTGCCG|ATGCATACGAGTCATTCGCGTACTAGAAGT
ATGCATACGAAAGGGGCTCTAGAAATCCTG|ACCGGACGAGATCGGATTCGTTACGGGCCC
GGGCGAGGGCAATACATACCCGGCACTAAG|TCGGCCGGCCTATGCATACGACTTGGCCGT
GGCCGGCCTATGCATACGAGTTCGTTCGGG|GGAAACTGGTTATACTTGGTTTGCCAAACC
CCCCTCTCCAAATGCAAGTCGGCCGGCCTA|CTATTAGCCTCCTCATGGCGCAAAGAAGAA
ACTGAGGCTTTATCAATTAACTGCCACGTT|TAAACGACATCTGTGTCATATATAAGCGTT
AATACCCCTCTCCAAATGCAAGTCGGCCGG|CGGTCTATTAGCCTCCTCATGGCGCAAAGA
TCTATATGTGATGAGTCATGACTGAGGCTT|ATATGTCAAAATCAAGGTTGTAAACGACAT
AACCACAGGAGTCTCGTAACGCCATGAATT|TTTTAGGCAAAGACACACCAATCTAGAGCG
GCATACGACAAGTCGGCCGGCCTATGCATA|CTATGCATACGATCAACGTGGCGAGTCGCT
TGCATACGACGGCCCGCGGTGGTGTATCTG|TCGGCCGGCCTATGCATACGAGGCCTATGC
ATTAGCCTCCTCATGGCGCAAAGAAGAACA|CTGCGCCCTACGACGGCCTTTACTACACAG
GGCCGGCCTATGCATACGATCAACGTGGCG|CAAGTCGGCCGGCCTATGCATACGAGTTCG
TCGGCCGGCCTATGCATACGACTGTTCTGT|CCTCTAGATCAAATAAATGCAAGTCGGCCG
AAATGCAAGTCGGCCGGCCTATGCATACGA|GGGCGAGGGCAATACATACCCGGCACTAAG
TACGAGAGTGTTTTAGGCAAAGACACACCA|GGCCACGTGGCGTGGGGCTACCCGTGCTGT
AACACAAAATGAAATGCAAGTCGGCCGGCC|GACTGTTCTGTCCATAAATGCAAGTCGGCC
TCGCGTACTAGAAGTTATACCGGCACCGAT|ACCTAAATACCCCTCTCCAAATGCAAGTCG
AATGCAAGTCGGCCGGCCTATGCATACGAC|GCAAGTCGGCCAAATGCAAGTCGGCCGGCC
AAGGGGCTCTAGAAATCCTGGAGATCACGT|ATCGGATTCGTTACGGGCCCGACTGTCATG
GGCCGGCCTATGCATACGAAAATGCAAGTC|AACGTGGCGAGTCGCTATGTGAGTGCTGGA
TGGTAACGCTTCTACAAACGCTCTAATCCT|GTTGGTGAAATGCAAGTCGGCCGGCCTATG
AGTTGGTGAAATGCAAGTCGGCCGGCCTAT|ACCTTAAATGCAAGTCGGCCAAATGCAAGT
AGGTACCTAAATACCCCTCTCCAAATGCAA|GCCACGTTACGGTCTATTAGCCTCCTCATG
TCAACGTGGCGAGTCGCTATGTGAGTGCTG|ATACGAGTTCGTTCGGGGAGTGCAATTCGT
CATACGAAAATGCAAGTCGGCCGGCCTATG|CGCTATGTGAGTGCTGGATTAACTCTGGTA
AAACGCTCTAATCCTCTAGATCAAATAAAT|GTCGGCCGGCCTATGCATACGACGGCCCGC
TCACCGGACGAGATCGGATTCGTTACGGGC|CCGCAATTTAAAATGCAAGTCGGCCGGCCT
GCGGTAGGAACCTTAAATGCAAGTCGGCCA|AGGCGAGATCGTCGGGATATGAGAAAGGTG
TGGGCGAGGGCAATACATACCCGGCACTAA|GTCGGCCGGCCTATGCATACGACTTGGCCG
TATGCATACGAAAACACAATGCGCGGCATT|ATGCATACGAAAATGCAAGTCGGCCGGCCT
GGCACCGATGCTTTCAACATGTTGCTACAC|TGCAAGTCGGCCGGCCTATGCATACGAGAG
GCCGTGTCCCGCAATTTAAAATGCAAGTCG|TGAATTTTCCTCGGAAGGTGAGCATTTACG
CTCTGGTAACGCTTCTACAAACGCTCTAAT|TTAGTTGGTGAAATGCAAGTCGGCCGGCCT
TATCTGTCGAATTCTTCGATACTTCCGGAA|CTATGCATACGAAAGGGGCTCTAGAAATCC
CTCCAAATGCAAGTCGGCCGGCCTATGCAT|AGCCTCCTCATGGCGCAAAGAAGAACAGAG
GTACTAGAAGTTATACCGGCACCGATGCTT|AAATACCCCTCTCCAAATGCAAGTCGGCCG
GTGACCATAATACCGAAATGCAAGAAATGC|GTGTGCGAAACACAAAATGAAATGCAAGTC
ACATCTAGCTAACAAATAGGTACCTAAATA|GGCTTTATCAATTAACTGCCACGTTACGGT
GTGATGAGTCATGACTGAGGCTTTATCAAT|AAAATCAAGGTTGTAAACGACATCTGTGTC
ACTGGTTATACTTGGTTTGCCAAACCGAAG|TGGAGATCACGTGGGATTGTATCCCAGTTG
TGCTTTCAACATGTTGCTACACCTAACCAC|GGCCGGCCTATGCATACGAGAGTGTTTTAG
TCGTCGGGATATGAGAAAGGTGGGCGAGGG|CCTCGAAATTGCAAATGCAAGTCGGCCGGC
TGGGCTTTGCGTGAGGTAAGAGCCGCTGGT|GACCTCTGAAATGCAAGTCGGCCGGCCTAT
ACGAGATCGGATTCGTTACGGGCCCGACTG|TTAAAATGCAAGTCGGCCGGCCTATGCATA
GTCCATAAATGCAAGTCGGCCGGCCTATGC|CGGCCTATGCATACGAGCAAGTCGGCCGGC
TGTTTTAGGCAAAGACACACCAATCTAGAG|GGCGTGGGGCTACCCGTGCTGTCAGCCCTC
TAGAAGTTATACCGGCACCGATGCTTTCAA|ACCCCTCTCCAAATGCAAGTCGGCCGGCCT
GCCTATGCATACGACTTGGCCGTGTCCCGC|AGGAGTCTCGTAACGCCATGAATTTTCCTC
AAATGCAAGTCGGCCGGCCTATGCATACGA|CCATAAATGCAAGTCGGCCGGCCTATGCAT
CGGATTCGTTACGGGCCCGACTGTCATGCA|GCAAGTCGGCCGGCCTATGCATACGAGTCA
ATATGTGATGAGTCATGACTGAGGCTTTAT|TGTCAAAATCAAGGTTGTAAACGACATCTG
CCTATGCATACGACAAGTCGGCCGGCCTAT|CCGGCCTATGCATACGATCAACGTGGCGAG
ATGAAATGCAAGTCGGCCGGCCTATGCATA|TGTCCATAAATGCAAGTCGGCCGGCCTATG
TTAGCCTCCTCATGGCGCAAAGAAGAACAG|TGCGCCCTACGACGGCCTTTACTACACAGT
TTGCAAATGCAAGTCGGCCGGCCTATGCAT|ATGTTGCTACACCTAACCACAGGAGTCTCG
AACTGCCACGTTACGGTCTATTAGCCTCCT|TATATAAGCGTTACTCCTCCTGCGCCCTAC
TCGGCCGGCCTATGCATACGAGGCCTATGC|CAATACATACCCGGCACTAAGACCTCACCG
TGCAAGAAATGCAAGTCGGCCGGCCTATGC|GAAATGCAAGTCGGCCGGCCTATGCATACG
CTTTCAACATGTTGCTACACCTAACCACAG|CCGGCCTATGCATACGAGAGTGTTTTAGGC
ATGCAAGTCGGCCGGCCTATGCATACGAGG|GCGAGGGCAATACATACCCGGCACTAAGAC
GTCGGCCGGCCTATGCATACGACGGCCCGC|GGCCAAATGCAAGTCGGCCGGCCTATGCAT
TCGTTACGGGCCCGACTGTCATGCAGATTT|TCGGCCGGCCTATGCATACGAGTCATTCGC
AAGACCTCACCGGACGAGATCGGATTCGTT|CGTGTCCCGCAATTTAAAATGCAAGTCGGC
GTGGTGTATCTGTCGAATTCTTCGATACTT|CGAGGCCTATGCATACGAAAGGGGCTCTAG
CGAGCAAGTCGGCCGGCCTATGCATACGAG|CGATACTTCCGGAAACTGGTTATACTTGGT
TCCTCTAGATCAAATAAATGCAAGTCGGCC|TATGCATACGACGGCCCGCGGTGGTGTATC
TAAAATGCAAGTCGGCCGGCCTATGCATAC|GGTGAGCATTTACGGGACATCTAGCTAACA
GACAAGTCGGCCGGCCTATGCATACGAAAA|ATACGATCAACGTGGCGAGTCGCTATGTGA
AAGCGGTAGGAACCTTAAATGCAAGTCGGC|TCAGGCGAGATCGTCGGGATATGAGAAAGG
GGGCCCGACTGTCATGCAGATTTTCCGGGT|GCCTATGCATACGAGTCATTCGCGTACTAG
TCATGACTGAGGCTTTATCAATTAACTGCC|GGTTGTAAACGACATCTGTGTCATATATAA
ACGTGGGATTGTATCCCAGTTGAGCCCCTC|CATGCAGATTTTCCGGGTGCCGTAAATCGG
TCAACCCATAGTACTGAAGGTCGGCCTGTT|TAACTGGGCTTTGCGTGAGGTAAGAGCCGC
GCTTTATCAATTAACTGCCACGTTACGGTC|ACATCTGTGTCATATATAAGCGTTACTCCT
TCGATACTTCCGGAAACTGGTTATACTTGG|GGGCTCTAGAAATCCTGGAGATCACGTGGG
TACTTCCGGAAACTGGTTATACTTGGTTTG|TCTAGAAATCCTGGAGATCACGTGGGATTG
CGGCCTATGCATACGAAAATGCAAGTCGGC|GTGGCGAGTCGCTATGTGAGTGCTGGATTA
TAACGCTTCTACAAACGCTCTAATCCTCTA|GGTGAAATGCAAGTCGGCCGGCCTATGCAT
GTCTATTAGCCTCCTCATGGCGCAAAGAAG|CCTCCTGCGCCCTACGACGGCCTTTACTAC
AATGCAAGTCGGCCGGCCTATGCATACGAG|GGCGAGGGCAATACATACCCGGCACTAAGA
CTGTCATGCAGATTTTCCGGGTGCCGTAAA|ATACGAGTCATTCGCGTACTAGAAGTTATA
GCATACGAAAACACAATGCGCGGCATTATC|CATACGAAAATGCAAGTCGGCCGGCCTATG
TAAATGCAAGTCGGCCGGCCTATGCATACG|CCCGCGGTGGTGTATCTGTCGAATTCTTCG
TCCGGAAACTGGTTATACTTGGTTTGCCAA|GAAATCCTGGAGATCACGTGGGATTGTATC
TAGCCTCCTCATGGCGCAAAGAAGAACAGA|GCGCCCTACGACGGCCTTTACTACACAGTA
ATCGTCGGGATATGAGAAAGGTGGGCGAGG|TCCTCGAAATTGCAAATGCAAGTCGGCCGG
CTGGAGATCACGTGGGATTGTATCCCAGTT|CCCGACTGTCATGCAGATTTTCCGGGTGCC
TACTTGGTTTGCCAAACCGAAGTCACCTAA|ACGTGGGATTGTATCCCAGTTGAGCCCCTC
TATGCATACGACCTCTGAAATGCAAGTCGG|GGTAACGCTTCTACAAACGCTCTAATCCTC
CTATGCATACGAGTTCGTTCGGGGAGTGCA|GGTTATACTTGGTTTGCCAAACCGAAGTCA
CGGCCGGCCTATGCATACGACAAGTCGGCC|AAGTCGGCCGGCCTATGCATACGATCAACG
CGTTACGGTCTATTAGCCTCCTCATGGCGC|CGTTACTCCTCCTGCGCCCTACGACGGCCT
CGACGGCCCGCGGTGGTGTATCTGTCGAAT|GGCCTATGCATACGAGGCCTATGCATACGA
ACCGATGCTTTCAACATGTTGCTACACCTA|AAGTCGGCCGGCCTATGCATACGAGAGTGT
TAGTACTGAAGGTCGGCCTGTTACGTGACC|CTTTGCGTGAGGTAAGAGCCGCTGGTGTGC
ACGGGACATCTAGCTAACAAATAGGTACCT|ACTGAGGCTTTATCAATTAACTGCCACGTT
GTCATTCGCGTACTAGAAGTTATACCGGCA|TAGGTACCTAAATACCCCTCTCCAAATGCA
ACTTCCGGAAACTGGTTATACTTGGTTTGC|CTAGAAATCCTGGAGATCACGTGGGATTGT
AGGCTTTATCAATTAACTGCCACGTTACGG|CGACATCTGTGTCATATATAAGCGTTACTC
CTATGTGAGTGCTGGATTAACTCTGGTAAC|GGAGTGCAATTCGTAAGAGATTAGTTGGTG
TAGGTACCTAAATACCCCTCTCCAAATGCA|TGCCACGTTACGGTCTATTAGCCTCCTCAT
ATATCAACCCATAGTACTGAAGGTCGGCCT|TCTTAACTGGGCTTTGCGTGAGGTAAGAGC
AAATCCTCGAAATTGCAAATGCAAGTCGGC|GATGCTTTCAACATGTTGCTACACCTAACC
CTGAAATGCAAGTCGGCCGGCCTATGCATA|AAACGCTCTAATCCTCTAGATCAAATAAAT
AATGCAAGTCGGCCAAATGCAAGTCGGCCG|GATATGAGAAAGGTGGGCGAGGGCAATACA
ATAAATGCAAGTCGGCCGGCCTATGCATAC|CTATGCATACGAGCAAGTCGGCCGGCCTAT
CAACGTGGCGAGTCGCTATGTGAGTGCTGG|TACGAGTTCGTTCGGGGAGTGCAATTCGTA
GTCCCGCAATTTAAAATGCAAGTCGGCCGG|TTTCCTCGGAAGGTGAGCATTTACGGGACA
ATGCAAGTCGGCCGGCCTATGCATACGACG|CAAGTCGGCCAAATGCAAGTCGGCCGGCCT
ATCCTCGAAATTGCAAATGCAAGTCGGCCG|TGCTTTCAACATGTTGCTACACCTAACCAC
TGAGCATTTACGGGACATCTAGCTAACAAA|TGAGTCATGACTGAGGCTTTATCAATTAAC
CAACATGTTGCTACACCTAACCACAGGAGT|CCTATGCATACGAGAGTGTTTTAGGCAAAG
CAAGTCGGCCGGCCTATGCATACGACTTGG|CACCTAACCACAGGAGTCTCGTAACGCCAT
ATGCATACGACCTCTGAAATGCAAGTCGGC|GTAACGCTTCTACAAACGCTCTAATCCTCT
ATGCAAGTCGGCCGGCCTATGCATACGATC|AGTCGGCCGGCCTATGCATACGACAAGTCG
TCGTAACGCCATGAATTTTCCTCGGAAGGT|CACACCAATCTAGAGCGATCTATATGTGAT
GGTGCCGTAAATCGGCACGAAATCCTCGAA|TAGAAGTTATACCGGCACCGATGCTTTCAA
ATGCATACGAGGCCTATGCATACGAAAGGG|CGGCACTAAGACCTCACCGGACGAGATCGG
CATGAATTTTCCTCGGAAGGTGAGCATTTA|CTAGAGCGATCTATATGTGATGAGTCATGA
TCAGGCGAGATCGTCGGGATATGAGAAAGG|GGCACGAAATCCTCGAAATTGCAAATGCAA
GGGACATCTAGCTAACAAATAGGTACCTAA|TGAGGCTTTATCAATTAACTGCCACGTTAC
GGCAAAGACACACCAATCTAGAGCGATCTA|GGCTACCCGTGCTGTCAGCCCTCCGAATAT
CAAATGCAAGTCGGCCGGCCTATGCATACG|TTGCTACACCTAACCACAGGAGTCTCGTAA
TCGAAATTGCAAATGCAAGTCGGCCGGCCT|TTCAACATGTTGCTACACCTAACCACAGGA
ACGAGTCATTCGCGTACTAGAAGTTATACC|CAAATAGGTACCTAAATACCCCTCTCCAAA
TCGGATTCGTTACGGGCCCGACTGTCATGC|TGCAAGTCGGCCGGCCTATGCATACGAGTC
GCATTTACGGGACATCTAGCTAACAAATAG|GTCATGACTGAGGCTTTATCAATTAACTGC
AACGCTCTAATCCTCTAGATCAAATAAATG|TCGGCCGGCCTATGCATACGACGGCCCGCG
AGTCGGCCGGCCTATGCATACGACGGCCCG|CGGCCAAATGCAAGTCGGCCGGCCTATGCA
GTACTGAAGGTCGGCCTGTTACGTGACCAT|TTGCGTGAGGTAAGAGCCGCTGGTGTGCGA
ACTGAAGGTCGGCCTGTTACGTGACCATAA|GCGTGAGGTAAGAGCCGCTGGTGTGCGAAA
CTCTGAAATGCAAGTCGGCCGGCCTATGCA|ACAAACGCTCTAATCCTCTAGATCAAATAA
GCACCGATGCTTTCAACATGTTGCTACACC|GCAAGTCGGCCGGCCTATGCATACGAGAGT
CCTATGCATACGACGGCCCGCGGTGGTGTA|CAAGTCGGCCGGCCTATGCATACGAGGCCT
CGAAACACAAAATGAAATGCAAGTCGGCCG|TACGACTGTTCTGTCCATAAATGCAAGTCG
ATGAGTCATGACTGAGGCTTTATCAATTAA|ATCAAGGTTGTAAACGACATCTGTGTCATA
ATACCGGCACCGATGCTTTCAACATGTTGC|CCAAATGCAAGTCGGCCGGCCTATGCATAC
CGATCAACGTGGCGAGTCGCTATGTGAGTG|TGCATACGAGTTCGTTCGGGGAGTGCAATT
TCTAGAAATCCTGGAGATCACGTGGGATTG|TCGTTACGGGCCCGACTGTCATGCAGATTT
AGACACACCAATCTAGAGCGATCTATATGT|CCCGTGCTGTCAGCCCTCCGAATATGTCAA
TGCATACGAGGCCTATGCATACGAAAGGGG|GGCACTAAGACCTCACCGGACGAGATCGGA
CTACAAACGCTCTAATCCTCTAGATCAAAT|GCAAGTCGGCCGGCCTATGCATACGACGGC
CTTGGTTTGCCAAACCGAAGTCACCTAAGC|GTGGGATTGTATCCCAGTTGAGCCCCTCAG
CGGCCTATGCATACGAGTTCGTTCGGGGAG|AACTGGTTATACTTGGTTTGCCAAACCGAA
CGGCCTATGCATACGACAAGTCGGCCGGCC|CGGCCGGCCTATGCATACGATCAACGTGGC
GGCCTATGCATACGAGCAAGTCGGCCGGCC|TGTCGAATTCTTCGATACTTCCGGAAACTG
GGTGAGCATTTACGGGACATCTAGCTAACA|GATGAGTCATGACTGAGGCTTTATCAATTA
GAAAGGGGCTCTAGAAATCCTGGAGATCAC|AGATCGGATTCGTTACGGGCCCGACTGTCA
